AdvancedSearch: Búsqueda avanzada 
AdvancedSearchTooltip: Seleccionar filtros de contenido
BreadcrumbsProductDocumentationHome: Inicio de documentación de productos
BreadcrumbsSearch: Buscar
Cancel: Cancelar
Close: Cerrar
DeleteText: Eliminar
ErrorOccured: Se ha producido un error
FilterUsers: Filtrar usuarios:
FoundationLoginOnly: Iniciar sesión
FoundationLoginRegister: Iniciar sesión / Registrarse
HandlerAdminOnlyAdmin: Acceso denegado
HandlerBundlePageAltCSHResult: Tema CSH alternativo encontrado
HandlerCategoriesCategoryXMLFileUploaded: Archivo XML de categorías cargado
HandlerClassificationUpdated: Mapa de clasificación actualizado
HandlerClassificationXMLFile: Mapa de clasificación actualizado
HandlerCommentsComments: comentarios
HandlerCommentsOneComment: 1 comentario
HandlerCommentsPostedCommentOn: ha publicado un comentario en:
HandlerContentRolesAreYouSureDelete: ¿Seguro que desea eliminar esta función de contenido?
HandlerContentRolesCRDeleted: Función de contenido eliminada
HandlerContentRolesErrorDeleting: Se ha producido un problema. No se ha eliminado la función de contenido.
HandlerCshAlternateCSHTopicFound: Tema CSH alternativo encontrado
HandlerCshCSHRulesUpdated: Reglas CSH actualizadas
HandlerCshInvalidAliases: Claves de alias no válidas encontradas en URL CSH
HandlerCshInvalidCSHRulesFile: Archivo de reglas CSH no válido
HandlerCshNewCshFile: Cargar nuevo archivo de configuración CSH
HandlerCshReservedAliasesUsed: Alias reservados utilizados en archivo de configuración CSH
HandlerCustomError400H2: 400
HandlerCustomError400H3: Solicitud incorrecta
HandlerCustomError401H2: 401
HandlerCustomError401H3: No autorizado
HandlerCustomError403H2: 403
HandlerCustomError403H3: Prohibido
HandlerCustomError404H2: 404
HandlerCustomError404H3: No encontrado
HandlerCustomError405H2: 405
HandlerCustomError405H3: Método no admitido
HandlerCustomError500H2: 500
HandlerCustomError500H3: Error interno del servidor
HandlerFontoDocumentSaved: Documento guardado
HandlerFontoErrorGeneratingUUID: Error al generar UUID
HandlerFontoErrorParsingID: Error al analizar ID
HandlerFontoErrorParsingXML: Error al analizar XML
HandlerFontoErrorParsingXMLToDocument: Error al analizar XML para transformarlo en documento
HandlerFontoNoFileFound: Archivo no encontrado
HandlerFontoNoIDFound: ID no encontrado
HandlerFontoUntitledFromCursor: Sin título: desde cursor
HandlerGroupsErrorReadingGroupID: Error al leer ID de grupo
HandlerGroupsGroupUpdated: Grupo actualizado
HandlerGroupsMustUseUniqueGroupName: Se debe utilizar un nombre de grupo exclusivo
HandlerGroupsNoGroupNameFound: No se ha encontrado ningún nombre de grupo
HandlerGroupsUnableAssignRole: No se puede asignar la función
HandlerHowtoContent: Contenido
HandlerHowtoDeleted: Artículo eliminado
HandlerHowtoInsufficientPermissions: Permisos insuficientes para editar este artículo
HandlerHowtoSaved: Guardado
HandlerHowtoTitle: Título
HandlerHtmlEmptyMyDocs: Vaciar Mis documentos
HandlerLangDefaultLanguageCodeFileUpdated: Archivo de código de idioma predeterminado actualizado
HandlerLangNewLangFile: Cargar nuevo archivo de código de idioma predeterminado
HandlerMyPubSourcePublication: Publicación de origen
HandlerProfileDisplayName: Nombre para mostrar
HandlerProfileScreenName: Nombre de pantalla
HandlerProfileUpdated: Perfil actualizado
HandlerProfileUsernameInUse: El nombre de usuario existe
HandlerRatingsInvalidRating: Calificación no válida
HandlerRatingsRatingRecorded: Se ha registrado su calificación
HandlerRatingsRatingUpdated: Se ha actualizado su calificación
HandlerRolesErrorReadingRoleID: Error al leer ID de función
HandlerRolesMustUseUniqueRoleName: Utilice un nombre de función exclusivo
HandlerRolesNoRoleNameFound: No se ha encontrado ningún nombre de función
HandlerRolesNotEnoughAdminUsersRemaining: No se pueden asignar usuarios
HandlerRolesSelectedPermissionsLessThenDefault: No se pueden asignar permisos: los permisos seleccionados son menos que el conjunto de permisos predeterminado
HandlerSearchAllResults: Todos los resultados
HandlerSearchNoResultsMsgTryFollowing: Nenhum resultado encontrado. Tente o seguinte:
HandlerSearchNoResultsMsgSpelledCorrectly: Certifique-se de que todas as palavras estão escritas corretamente.
HandlerSearchNoResultsMsgTryDifferent: Tente palavras-chave diferentes.
HandlerSearchNoResultsMsgMoreGeneral: Tente palavras-chave mais gerais.
HandlerSearchNoResultsMsgNoFindProdVer: Não encontrar o seu produto ou versão mais recente? Vá para a Segurança ServicePortal Intel.
HandlerSearchNoResults: Ningún resultado
HandlerSearchOneResult: Un resultado
HandlerSitemapFile: Archivo de mapa del sitio
HandlerSitemapFileUploaded: Se ha actualizado el mapa del sitio correctamente.
HandlerSubjectSchemeInvalidSubjectSchemeLocalizationFile: Archivo de localización de esquema de asunto no válido
HandlerSubjectSchemeLangDeleted lang@Text: Archivo de localización de #{lang} eliminado
HandlerSubjectSchemeLangsAvailable: Idiomas disponibles
HandlerSubjectSchemeLangsDeleteConfirm: ¿Seguro que desea eliminar el archivo de localización? 
HandlerSubjectSchemeLangsDeleteError: Error al eliminar el archivo de localización.
HandlerSubjectSchemeLangsNewFile: Cargar nuevo archivo de localización de esquema de asunto
HandlerSubjectSchemeLangUpdated lang@Text: Archivo de localización de #{lang} actualizado
HandlerSubjectSchemeLangUploaded lang@Text: Archivo de localización de #{lang} cargado 
HandlerSubjectSchemeProblemOccurredWhileUploadingSubjectScheme: Se ha producido un problema al cargar el esquema de asunto.
HandlerSubjectSchemeSubjectSchemeUploadedSuccessfully: Esquema de asunto cargado correctamente
HandlerSubjectSchemeUnknownLanguageCode: Código de idioma desconocido
HandlerSubjectSchemeUpdated: Esquema de asunto actualizado
HandlerSubjectSchemeXMLFile: Archivo XML de esquema de asunto
HandlerUploadBundleBundle: paquete
HandlerUploadBundleDeleteError x@Text: Error al eliminar #{x}
HandlerUploadBundleDeleteSuccess x@Text: Se ha eliminado #{x} correctamente
HandlerUploadBundleError: Error
HandlerUploadBundleErrorPleaseUpdateSuiteBundleVersion: Error: actualice la versión del paquete
HandlerUploadBundleNoContentToDelete x@Text: No hay ningún contenido para eliminar en #{x} 
HandlerUploadBundleOneBundleError: Error al rellenar el paquete cargado
HandlerUploadBundlePublicationUploadedSuccessfully: Publicación cargada correctamente
HandlerUploadBundleSheaf: sheaf
HandlerUsersAddedSuccess: Usuario agregado correctamente
HandlerUsersBadEmail: Esa dirección de correo electrónico no está registrada
HandlerUsersCRCreated: Grupo de función de contenido creado
HandlerUsersCRGroupNameInUse: El nombre de la función de contenido ya se está utilizando
HandlerUsersCRSetGroupName: Establezca un nombre para este grupo de función de contenido
HandlerUsersCRUpdated: Grupo de función de contenido actualizado
HandlerUsersDefineCR: Definir nuevo grupo de función de contenido
HandlerUsersDeleteSuccess: Usuario eliminado correctamente
HandlerUsersEmailError: Error al enviar el correo electrónico de restablecimiento de contraseña
HandlerUsersInvalidToken: Token no válido
HandlerUsersNoResetToken: No hay ningún token restablecido
HandlerUsersNoRoleIdFound: No se ha encontrado ningún ID de función
HandlerUsersPasswordEmailSent: Correo electrónico de restablecimiento de contraseña enviado
HandlerUsersRegisterSuccess: Usuario registrado correctamente
HandlerUsersResetPasswordError: Error al restablecer la contraseña
HandlerUsersRolesUpdated: Funciones de usuario actualizadas
HandlerUsersUnableToAssignUserPermissionRole: No se puede asignar la función de permisos de usuario
HandlerUsersUnknownError: Error desconocido
HideTOC: Ocultar tabla de contenido
ImportAddHelperProblemRunningAddHelper: Problema al ejecutar addHelper
ImportBundlesTooManyTopics num@Int: Se puede publicar un máximo de #{show num} temas. Seleccione menos temas y vuelva a intentarlo.
ImportElasticAnalyzerError: - Nota: Error del analizador personalizado; véase el registro para obtener detalles. Utilizando analizador predeterminado. 
ImportElasticErrorRebuilding: Error al reconstruir el índice; véase el registro para obtener más detalles.
ImportElasticErrorUpdating: Error al actualizar el índice; véase el registro para obtener más detalles.
ImportElasticIndexRebuilt x@Text: Índice reconstruido correctamente #{x}
ImportElasticIndexUpdated x@Text: Índice actualizado correctamente #{x}
ImportElasticNoPagesFound: No se ha encontrado ninguna página en la base de datos; restablecimiento del índice.
ImportElasticNoPagesInBundle: No se ha encontrado ninguna página en la carga
ImportInvalidPassword: Contraseña no válida
ImportRatingsOneRating: 1 calificación
ImportRatingsRatings: Calificaciones
ImportRolesPermissionDenied: Permiso denegado
ImportSearchNoCategoriesUploaded: No se ha cargado ningún archivo XML de categorías
ImportSearchUnknownTopicLink: *** vínculo de tema desconocido ***
ImportUsersCaptchaError: reCAPTCHA no válido 
ImportUsersCaptchaParseError: Error de reCAPTCHA
ImportUsersEmailFieldError: No se ha encontrado ningún campo de correo electrónico.
ImportUsersFldEmail: Correo electrónico
ImportUsersFldFirstName: Nombre
ImportUsersFldLastName: Apellidos
ImportUsersFldPassword: Contraseña
ImportUsersFldReenterPass: Repita la contraseña
ImportUsersInvalidPass: Contraseña no válida: la contraseña seleccionada debe tener 8 caracteres como mínimo e incluir al menos 1 letra mayúscula, 1 letra minúscula, 1 carácter especial y 1 número.
LoggedInAs email@Text: Sesión iniciada como #{email}.
Manuals: Manuales
PDFPage: Página
ProductDocumentationSplashTitle: Documentación de productos 
PublishHowto: Publicar
ResultsPerPage: Resultados por página
ResultsPerPageShowFirst: Mostrar
ResultsPerPageShow: por página
Search: Buscar en documentación de productos
SearchContent: Buscar en este contenido
SearchHome: Buscar en documentación de productos
ShowTOC: Mostrar tabla de contenido
SSOLoginParamError: Se ha producido un error con los parámetros de inicio de sesión de SSO
SSOLoginTryAgain: Intente volver a iniciar sesión con
SwitchLang: Cambiar idioma
TemplaesBundlesTitle: Biblioteca de documentación
TemplateAddHelperCancel: Cancelar
TemplateAddHelperSave: Guardar
TemplateAddHelperSaveAndClose: Guardar y cerrar
TemplateAddUserAddUser: Agregar usuario
TemplateAddUserCancel: Cancelar
TemplateAddUserPasswordMessage: La contraseña debe tener 8 caracteres como mínimo e incluir al menos 1 letra mayúscula, 1 letra minúscula, 1 carácter especial y 1 número.
TemplateAdminArticleManagement: Administración de artículos
TemplateAdminContentRoleGroups: Grupos de función de contenido
TemplateAdminCSHConfigFile: Descargar o actualizar archivo de configuración CSH
TemplateAdminElasticReindex: Regenerar índice de búsqueda
TemplateAdminExportComments: Exportar comentarios
TemplateAdminExportRatings: Exportar calificaciones
TemplateAdminManageManuals: Administrar manuales
TemplateAdminManageResourceManuals: Administrar paquetes de recursos
TemplateAdminResourceIdCsv: Descargar archivo Excel de ResourceIds
TemplateAdminSitemap: Administrar mapa del sitio
TemplateAdminSubjectSchemeLocalization: Administrar localización de esquema de asunto
TemplateAdminTitle: Administración
TemplateAdminUploadCategoryXML: Administrar archivo XML de categorías
TemplateAdminUploadCategoryXml: Cargar un nuevo archivo XML de categorías
TemplateAdminUploadNewLangFile: Cargar un nuevo archivo de código de idioma predeterminado
TemplateAdminUploadSubjectScheme: Administrar esquema de asunto
TemplateAdminUserGroups: Grupos de usuarios
TemplateAdminUserManagement: Administración de usuarios
TemplateAdminUserRoles: Funciones de usuario
TemplateBundlePageCollapse: Contraer
TemplateBundlePageCollapseTooltip: Contraer todos los títulos
TemplateBundlePageComments: Comentarios
TemplateBundlePageContents: Contenido
TemplateBundlePageExpand: Expandir
TemplateBundlePageExpandTooltip: Expandir tabla de contenido
TemplateBundlePageFeedback: Comentarios
TemplateBundlePageFeedbackThankYou: Gracias. Se han enviado sus comentarios. 
TemplateBundlePageFeedbackTooltip: Enviar comentarios
TemplateBundlePageFilterTitle: Seleccione una o varias opciones
TemplateBundlePageNext: Siguiente
TemplateBundlePageNextTopicTooltip: Ir al siguiente tema
TemplateBundlePageNo: No
TemplateBundlePagePrevious: Anterior 
TemplateBundlePagePrevTopicTooltip: Ir al tema anterior
TemplateBundlePagePrint: Imprimir
TemplateBundlePagePrintTooltip: Imprimir tema
TemplateBundlePagePrivacy: Para proteger su privacidad, no incluya información de contacto en sus comentarios. Revise nuestra política
TemplateBundlePagePrivacyLast: de privacidad.
TemplateBundlePageProvideFeedbackCharsLeft: 500 caracteres restantes
TemplateBundlePageProvideFeedbackTooltip: Proporcionar comentarios
TemplateBundlePageSaveAsPDF: Guardar como PDF
TemplateBundlePageSavePDFTooltip: Guardar como PDF
TemplateBundlePageSaveSelectedTopic: Guardar tema seleccionado
TemplateBundlePageSaveSelectedTopicAndSubtopics: Guardar temas y temas secundarios seleccionados
TemplateBundlePageSeeAlso: Véase también
TemplateBundlePageSend: Enviar
TemplateBundlePageSendLink: Enviar
TemplateBundlePageSendLinkTooltip: Enviar vínculo a tema
TemplateBundlePageSubmit: Enviar
TemplateBundlePageWasThisInformationHelpful: ¿Ha sido útil esta información?
TemplateBundlePageYEs: Sí
TemplateBundlesDeleteLanguage: Eliminar idioma
TemplateBundlesDeleteManual: Eliminar manual
TemplateBundlesDownload: Descargar paquete
TemplateBundlesDownloadClassification: Descargar XML de clasificación
TemplateBundlesHiddenBundle: Manual oculto
TemplateBundlesSearchManuals: Buscar en manuales
TemplateBundlesUploadClassification: Cargar XML de clasificación
TemplateClassificationForManual: Para manual
TemplateClassificationUploadClassificationMap: Cargar XML de mapa de clasificación
TemplateClassificationWarnReindex: NOTA: Si se carga un mapa de clasificación, se reindizará todo el sitio. Esta operación puede durar varios minutos.
TemplateContentRolesCRGroups: Grupos de función de contenido
TemplateContentRolesDefineNewCR: Definir nueva función de contenido
TemplateDefaultLayoutAdministration: Administración
TemplateDefaultLayoutArticles: Artículos
TemplateDefaultLayoutBrowseDocumentation: Examinar
TemplateDefaultLayoutDocumentation: Biblioteca de documentación
TemplateDefaultLayoutHome: Inicio
TemplateDefaultLayoutLanguages: United States - English
TemplateDefaultLayoutLinksCareers: Oportunidades de empleo
TemplateDefaultLayoutLinksContactUs: Contacto
TemplateDefaultLayoutLinksIntelCorp: © Intel Corporation
TemplateDefaultLayoutLinksLegalContractsandTerms: Contratos y términos legales
TemplateDefaultLayoutLinksLegalNotices: Avisos legales  
TemplateDefaultLayoutLinksPrivacy: Intimidad
TemplateDefaultLayoutLinksSiteMap: Mapa del sitio
TemplateDefaultLayoutLinksWebsiteFeedback: Comentarios acerca del sitio web
TemplateDefaultLayoutLogout: Cerrar sesión
TemplateDefaultLayoutProfile: Perfil
TemplateDefaultLayoutVideos: Vídeos
TemplateFilterCurrentPublication: Publicación actual
TemplateRequestResetPasswordEmail: Correo electrónico
TemplateRequestResetPasswordSubmit: Correo electrónico de solicitud de restablecimiento de contraseña
TemplateSearchCurrentPublication name@Text: La búsqueda actual está limitada a la publicación '#{name}'
TemplateSearchPageClearTooltip: Borrar filtros
TemplateSearchPageFirstPageTooltip: Ir a la primera página
TemplateSearchPageLastPageTooltip: Ir a la última página
TemplateSearchPageNextPageTooltip: Ir a la página siguiente
TemplateSearchPagePrevPageTooltip: Ir a la página anterior
TemplateSearchPublicationTitle: Publicación
TemplateSearchSortbyCreatedAsc: Fecha de creación - Ascendente
TemplateSearchSortbyCreatedDec: Fecha de creación - Descendente
TemplateSearchSortbyScore: Calificación
TemplateSearchSortbyUpdatedAsc: Fecha de adición - Ascendente
TemplateSearchSortbyUpdatedDec: Fecha de adición - Descendente
TemplateSearchSortbyViews: Número de vistas
TemplatesSearchPageClear: Borrar
TemplatesSearchPageCurrentResultsFirst: Resultados
TemplatesSearchPageCurrentResults: de
TemplatesSearchPageRefilneResults: Refinar resultados
TemplatesSearchPageResultUpdated: Actualizado
TemplateUploadSitemapDisable: Desactivar mapa del sitio
TemplateUploadSitemapDisabled: Mapa del sitio desactivado
TemplateUploadSitemapDisabledWord: Desactivado
TemplateUploadSitemapDownloadSitemap: Descargar sitemap.xml
TemplateUploadSitemapEnable: Activar mapa del sitio
TemplateUploadSitemapEnabled: Mapa del sitio activado
TemplateUploadSitemapEnabledWord: Activado
TemplateUploadSitemapLegend: Cargar sitemap.xml
TemplateUploadSitemapStatus sts@Text: El mapa del sitio es #{sts}
TextPass txt@Text: #{txt}
Upload: Cargar
UploadLink: Cargar publicación
YesodAuthStormPathSSOErrorOccured: Se ha producido un error
YesodAuthStormPathSSOLoginParamError: Se ha producido un error con los parámetros de inicio de sesión de SSO
YesodAuthStormPathSSOLoginTryAgain: Intente volver a iniciar sesión con
LoginSite: Iniciar sesión
LoginSiteEmail: Dirección de correo electrónico
LoginSiteForgotPassword: Contraseña olvidada
LoginSiteMessage: Usted ya está conectado
LoginSiteZD: ZoominDocs Entrar
TemplateAdminCategoryfile: Archivo XML de la categoría
TemplateAdminCshCurrent: Reglas actuales de CSH
TemplateAdminCshDownload: Descargar el archivo de configuración actual de CSH
TemplateAdminCshRuleContents: Contenido de regla
TemplateAdminCshRuleName: Nombre de regla
TemplateAdminCshRulePriority: Prioridad de regla
TemplateAdminCshUpload: Cargar archivo CSH Config
TemplateAdminCurrentContentRoleGroups: Grupos de roles de contenido actual
TemplateAdminDownloadDefaultLanguage: Descargar el archivo de idioma predeterminado actual
TemplateAdminDownloadcurrentCategory: Descargar el archivo XML de las categorías actuales
TemplateAdminListGroupCurrentGroups: Grupos actuales
TemplateAdminListGroupDefineNewGroup: Definir nuevo grupo
TemplateAdminListRoleAdmin: admin
TemplateAdminListRoleCurrentRoles: Funciones actuales
TemplateAdminListRoleDefineNewRole: Definir nueva función
TemplateAdminListRoleRolesPublic: Public
TemplateAdminListRoleViewer: visor
TemplateAdminListUsersAction: Acción
TemplateAdminListUsersDeleteUser: Eliminar usuario
TemplateAdminListUsersEditPermissions: Editar permisos
TemplateAdminListUsersEmail: Email
TemplateAdminListUsersFullName: Nombre completo
TemplateAdminListUsersResetPassword: Restablecer contraseña
TemplateAdminSubjectSchemeDeleteLanguage: Elimina el archivo de idioma
TemplateAdminSubjectSchemeDescargar: Descargar
TemplateAdminSubjectSchemeDownloadLanguage: Descargar archivo de idioma
TemplateAdminSubjectSchemeExistingLocalizations: Localizaciones existentes
TemplateAdminSubjectSchemeLanguage: Idioma
TemplateAdminSubjectSchemeLocalizationTitle: Asignatura de la localización del esquema
TemplateAdminSubjectSchemeUpdate: Actualizar
TemplateAdminSubjectSchemeUpdateLanguage: Actualizar archivo de idioma
TemplateAdminUploadCategoryfile: Cargar archivo de categoría
TemplateAdminUploadDefaultLanguage: Subir archivo de idioma predeterminado
TemplateAdminUploadSiteMapFile: Subir archivo de mapa de sitio
TemplateSubjectSchemeUpload: Subir esquema de asunto
TemplateSubjectSchemeWarnReindex: NOTA: cargar un nuevo esquema de asunto hará que todo el sitio se vuelva a indexar. Esto puede tomar varios minutos.
TemplatesSubjectSchemeChooseFile: Elija Archivo (pregunte Vlatko, no en html)
TemplatesSubjectSchemeDownloadcurrent: Descargue el esquema actual del tema
TemplatesSubjectSchemeNoFileChosen: No se ha seleccionado ningún archivo