AdvancedSearch: Tarkennettu haku 
AdvancedSearchTooltip: Valitse sisältösuodattimet
BreadcrumbsProductDocumentationHome: Tuotedokumentaation etusivu
BreadcrumbsSearch: Hae
Cancel: Peruuta
Close: Sulje
DeleteText: Poista
ErrorOccured: Järjestelmässä tapahtui virhe
FilterUsers: Suodata käyttäjiä:
FoundationLoginOnly: Kirjaudu sisään
FoundationLoginRegister: Kirjaudu sisään / Rekisteröidy
HandlerAdminOnlyAdmin: Pääsy evätty
HandlerBundlePageAltCSHResult: Vaihtoehtoinen CSH-aihe löytyi.
HandlerCategoriesCategoryXMLFileUploaded: Luokkien XML-tiedosto lähetetty
HandlerClassificationUpdated: Luokittelukartta on päivitetty.
HandlerClassificationXMLFile: Päivitetty luokittelukartta
HandlerCommentsComments: kommenttia
HandlerCommentsOneComment: 1 kommentti
HandlerCommentsPostedCommentOn: julkaisi kommentin aiheesta:
HandlerContentRolesAreYouSureDelete: Haluatko varmasti poistaa tämän sisältöroolin?
HandlerContentRolesCRDeleted: Sisältörooli on poistettu.
HandlerContentRolesErrorDeleting: Järjestelmässä ilmeni ongelma. Sisältöroolia ei poistettu.
HandlerCshAlternateCSHTopicFound: Vaihtoehtoinen CSH-aihe löytyi
HandlerCshCSHRulesUpdated: CSH-säännöt on päivitetty
HandlerCshInvalidAliases: CSH:n URL-osoitteesta löytyi virheelliset aliasavaimet.
HandlerCshInvalidCSHRulesFile: Virheellinen CSH-sääntötiedosto
HandlerCshNewCshFile: Lähetä uusi CSH-määritystiedosto
HandlerCshReservedAliasesUsed: CSH-määritystiedostossa on käytössä varatut aliakset.
HandlerCustomError400H2: 400
HandlerCustomError400H3: Virheellinen pyyntö
HandlerCustomError401H2: 401
HandlerCustomError401H3: Ei sallittu
HandlerCustomError403H2: 403
HandlerCustomError403H3: Estetty
HandlerCustomError404H2: 404
HandlerCustomError404H3: Ei löydy
HandlerCustomError405H2: 405
HandlerCustomError405H3: Menetelmä ei ole sallittu
HandlerCustomError500H2: 500
HandlerCustomError500H3: Sisäinen palvelinvirhe
HandlerFontoDocumentSaved: Tiedosto tallennettu
HandlerFontoErrorGeneratingUUID: Virhe luotaessa UUID-tunnusta
HandlerFontoErrorParsingID: Virhe jäsennettäessä tunnusta
HandlerFontoErrorParsingXML: Virhe jäsennettäessä XML-tiedostoa
HandlerFontoErrorParsingXMLToDocument: Virhe jäsennettäessä XML-tiedostoa asiakirjaksi
HandlerFontoNoFileFound: Tiedostoa ei löytynyt
HandlerFontoNoIDFound: Tunnusta ei löytynyt
HandlerFontoUntitledFromCursor: Nimetön - kohdistimelta
HandlerGroupsErrorReadingGroupID: Virhe luettaessa ryhmätunnusta
HandlerGroupsGroupUpdated: Ryhmä on päivitetty
HandlerGroupsMustUseUniqueGroupName: Käytä ainutlaatuista ryhmänimeä
HandlerGroupsNoGroupNameFound: Ryhmänimeä ei löytynyt
HandlerGroupsUnableAssignRole: Roolia ei voitu määrittää
HandlerHowtoContent: Sisältö
HandlerHowtoDeleted: Artikkeli on poistettu.
HandlerHowtoInsufficientPermissions: Käyttöoikeudet eivät riitä tämän artikkelin muokkaamiseen.
HandlerHowtoSaved: Tallennettu
HandlerHowtoTitle: Otsikko
HandlerHtmlEmptyMyDocs: Tyhjennä MyDocs
HandlerLangDefaultLanguageCodeFileUpdated: Päivitetty oletusarvoinen kielikooditiedosto
HandlerLangNewLangFile: Lähetä uusi oletusarvoinen kielikooditiedosto
HandlerMyPubSourcePublication: Lähdejulkaisu
HandlerProfileDisplayName: Näyttönimi
HandlerProfileScreenName: Näyttönimi
HandlerProfileUpdated: Profiili on päivitetty.
HandlerProfileUsernameInUse: Olemassa oleva käyttäjänimi
HandlerRatingsInvalidRating: Virheellinen luokitus
HandlerRatingsRatingRecorded: Luokituksesi on tallennettu
HandlerRatingsRatingUpdated: Luokituksesi on päivitetty
HandlerRolesErrorReadingRoleID: Virhe luettaessa roolitunnusta
HandlerRolesMustUseUniqueRoleName: Käytä ainutlaatuista roolinimeä
HandlerRolesNoRoleNameFound: Roolinimeä ei löytynyt
HandlerRolesNotEnoughAdminUsersRemaining: Käyttäjiä ei voitu määrittää
HandlerRolesSelectedPermissionsLessThenDefault: Käyttöoikeuksia ei voitu määrittää: valitut käyttöoikeudet ovat pienempiä kuin oletusarvoinen käyttöoikeusjoukko
HandlerSearchAllResults: Kaikki tulokset
HandlerSearchNoResultsMsgTryFollowing: Ei tuloksia. Kokeile seuraavia:
HandlerSearchNoResultsMsgSpelledCorrectly: Varmista, että kaikki sanat on kirjoitettu oikein.
HandlerSearchNoResultsMsgTryDifferent: Kokeile eri avainsanoja.
HandlerSearchNoResultsMsgMoreGeneral: Kokeile yleisempiä hakusanoja.
HandlerSearchNoResultsMsgNoFindProdVer: Siirry Intel Security huoltoportaali. Älä löydä tuotetta tai versio? 
HandlerSearchNoResults: Ei tuloksia
HandlerSearchOneResult: Yksi tulos
HandlerSitemapFile: Sivustokarttatiedosto
HandlerSitemapFileUploaded: Sivustokartta on päivitetty.
HandlerSubjectSchemeInvalidSubjectSchemeLocalizationFile: Virheellinen aihemallin lokalisointitiedosto
HandlerSubjectSchemeLangDeleted lang@Text: #{lang} poistettu lokalisointitiedosto
HandlerSubjectSchemeLangsAvailable: Käytettävissä olevat kielet
HandlerSubjectSchemeLangsDeleteConfirm: Haluatko varmasti poistaa lokalisointitiedoston? 
HandlerSubjectSchemeLangsDeleteError: Virhe poistettaessa lokalisointitiedostoa.
HandlerSubjectSchemeLangsNewFile: Lähetä uusi aihemallin lokalisointitiedosto
HandlerSubjectSchemeLangUpdated lang@Text: #{lang} päivitetty lokalisointitiedosto
HandlerSubjectSchemeLangUploaded lang@Text: #{lang} lähetetty lokalisointitiedosto 
HandlerSubjectSchemeProblemOccurredWhileUploadingSubjectScheme: Järjestelmässä ilmeni ongelma lähetettäessä aihemallia.
HandlerSubjectSchemeSubjectSchemeUploadedSuccessfully: Aihemalli on lähetetty
HandlerSubjectSchemeUnknownLanguageCode: Tuntematon kielikoodi
HandlerSubjectSchemeUpdated: Aihemalli on päivitetty.
HandlerSubjectSchemeXMLFile: Aihemallin XML-tiedosto
HandlerUploadBundleBundle: paketti
HandlerUploadBundleDeleteError x@Text: Virhe poistettaessa #{x}
HandlerUploadBundleDeleteSuccess x@Text: #{x} on poistettu
HandlerUploadBundleError: Virhe
HandlerUploadBundleErrorPleaseUpdateSuiteBundleVersion: Virhe - päivitä pakettiversiosi
HandlerUploadBundleNoContentToDelete x@Text: Ei poistettavaa sisältöä sijainnissa #{x} 
HandlerUploadBundleOneBundleError: Virhe täytettäessä lähetettyä pakettia
HandlerUploadBundlePublicationUploadedSuccessfully: Julkaisu on lähetetty
HandlerUploadBundleSheaf: sheaf
HandlerUsersAddedSuccess: Käyttäjä on lisätty
HandlerUsersBadEmail: Sähköpostiosoitetta ei ole rekisteröity
HandlerUsersCRCreated: Sisältörooliryhmä on luotu.
HandlerUsersCRGroupNameInUse: Sisältörooliryhmälle valittu nimi on jo käytössä
HandlerUsersCRSetGroupName: Anna sisältörooliryhmälle nimi
HandlerUsersCRUpdated: Sisältörooliryhmä on päivitetty.
HandlerUsersDefineCR: Määritä uusi sisältörooliryhmä
HandlerUsersDeleteSuccess: Käyttäjä on poistettu
HandlerUsersEmailError: Virhe lähetettäessä salasanan palautussähköpostia.
HandlerUsersInvalidToken: Virheellinen tunnus
HandlerUsersNoResetToken: Ei palautustunnusta
HandlerUsersNoRoleIdFound: Roolitunnusta ei löytynyt
HandlerUsersPasswordEmailSent: Salasanan palautussähköposti on lähetetty.
HandlerUsersRegisterSuccess: Käyttäjä on rekisteröity
HandlerUsersResetPasswordError: Virhe palautettaessa salasanaa.
HandlerUsersRolesUpdated: Käyttäjäroolit on päivitetty.
HandlerUsersUnableToAssignUserPermissionRole: Käyttäjän käyttöoikeusroolia ei voitu määrittää
HandlerUsersUnknownError: Tuntematon virhe
HideTOC: Piilota sisällysluettelo
ImportAddHelperProblemRunningAddHelper: Ongelma addHelperin suorittamisessa
ImportBundlesTooManyTopics num@Int: Korkeintaan #{show num} aihetta voidaan julkaista. Valitse vähemmän aiheita ja yritä uudelleen.
ImportElasticAnalyzerError: - Huomautus: Virhe mukautetussa analysointitoiminnossa, katso lisätietoja lokista. Oletusarvoinen analysointitoiminto käytössä. 
ImportElasticErrorRebuilding: Virhe muodostettaessa indeksiä uudelleen - katso lisätietoja lokista.
ImportElasticErrorUpdating: Virhe päivitettäessä indeksiä - katso lisätietoja lokista.
ImportElasticIndexRebuilt x@Text: Indeksi on muodostettu uudelleen #{x}
ImportElasticIndexUpdated x@Text: Indeksi on päivitetty #{x}
ImportElasticNoPagesFound: Tietokannasta ei löytynyt sivuja - indeksi palautettu.
ImportElasticNoPagesInBundle: Lähetyksestä ei löytynyt sivuja
ImportInvalidPassword: Virheellinen salasana
ImportRatingsOneRating: 1 luokitus
ImportRatingsRatings: Luokitusta
ImportRolesPermissionDenied: Käyttöoikeutta ei myönnetty
ImportSearchNoCategoriesUploaded: Luokkien XML-tiedostoa ei ole lähetetty
ImportSearchUnknownTopicLink: *** tuntematon aihelinkki ***
ImportUsersCaptchaError: Virheellinen reCAPTCHA 
ImportUsersCaptchaParseError: reCAPTCHA-virhe
ImportUsersEmailFieldError: Sähköpostikenttää ei löytynyt.
ImportUsersFldEmail: Sähköposti
ImportUsersFldFirstName: Etunimi
ImportUsersFldLastName: Sukunimi
ImportUsersFldPassword: Salasana
ImportUsersFldReenterPass: Kirjoita salasana uudelleen
ImportUsersInvalidPass: Virheellinen salasana: salasanassa on oltava vähintään kahdeksan merkkiä ja sen on sisällettävä vähintään yksi iso kirjain, yksi pieni kirjain, yksi erikoismerkki ja yksi numero.
LoggedInAs email@Text: Kirjautunut käyttäjänä #{email}.
Manuals: Käyttöoppaat
PDFPage: Sivu
ProductDocumentationSplashTitle: Tuotedokumentaatio 
PublishHowto: Julkaise
ResultsPerPage: Tulosta sivulla
ResultsPerPageShowFirst: Näytä
ResultsPerPageShow: tulosta sivulla
Search: Etsi tuotedokumentaatiota
SearchContent: Etsi tästä sisällöstä
SearchHome: Etsi tuotedokumentaatiota
ShowTOC: Näytä sisällysluettelo
SSOLoginParamError: SSO-kirjautumisparametrivirhe
SSOLoginTryAgain: Yritä kirjautua uudelleen tunnuksella
SwitchLang: Vaihda kieltä
TemplaesBundlesTitle: Dokumentaatiokirjasto
TemplateAddHelperCancel: Peruuta
TemplateAddHelperSave: Tallenna
TemplateAddHelperSaveAndClose: Tallenna ja sulje
TemplateAddUserAddUser: Lisää käyttäjä
TemplateAddUserCancel: Peruuta
TemplateAddUserPasswordMessage: Salasanassa on oltava vähintään kahdeksan merkkiä ja sen on sisällettävä vähintään yksi iso kirjain, yksi pieni kirjain, yksi erikoismerkki ja yksi numero.
TemplateAdminArticleManagement: Artikkelien hallinta
TemplateAdminContentRoleGroups: Sisältörooliryhmät
TemplateAdminCSHConfigFile: Lataa tai päivitä CSH-määritystiedosto
TemplateAdminElasticReindex: Muodosta hakuindeksi uudelleen
TemplateAdminExportComments: Vie kommentit
TemplateAdminExportRatings: Vie luokitukset
TemplateAdminManageManuals: Käyttöoppaiden hallinta
TemplateAdminManageResourceManuals: Hallinnoi resurssipaketteja
TemplateAdminResourceIdCsv: Lataa ResurssiTunnukset-Excel-tiedosto
TemplateAdminSitemap: Hallinnoi sivustokarttaa
TemplateAdminSubjectSchemeLocalization: Aihemallin lokalisoinnin hallinta
TemplateAdminTitle: Hallinta
TemplateAdminUploadCategoryXML: Halinnoi luokkien XML-tiedostoa
TemplateAdminUploadCategoryXml: Lähetä uusi luokkien XML-tiedosto
TemplateAdminUploadNewLangFile: Lähetä uusi oletusarvoinen kielikooditiedosto
TemplateAdminUploadSubjectScheme: Aihemallin hallinta
TemplateAdminUserGroups: Käyttäjäryhmät
TemplateAdminUserManagement: Käyttäjien hallinta
TemplateAdminUserRoles: Käyttäjäroolit
TemplateBundlePageCollapse: Kutista
TemplateBundlePageCollapseTooltip: Kutista kaikki otsikot
TemplateBundlePageComments: Kommentit
TemplateBundlePageContents: Sisällys
TemplateBundlePageExpand: Laajenna
TemplateBundlePageExpandTooltip: Laajenna sisällysluettelo
TemplateBundlePageFeedback: Palaute
TemplateBundlePageFeedbackThankYou: Kiitos! Kommenttisi on lähetetty. 
TemplateBundlePageFeedbackTooltip: Lähetä palautetta
TemplateBundlePageFilterTitle: Valitse vähintään yksi vaihtoehto
TemplateBundlePageNext: Seuraava
TemplateBundlePageNextTopicTooltip: Siirry seuraavaan aiheeseen
TemplateBundlePageNo: Ei
TemplateBundlePagePrevious: Edellinen 
TemplateBundlePagePrevTopicTooltip: Siirry edelliseen aiheeseen
TemplateBundlePagePrint: Tulosta
TemplateBundlePagePrintTooltip: Tulosta aihe
TemplateBundlePagePrivacy: Tietoturvasyistä älä sisällytä palautteeseen yhteystietojasi. Tutustu 
TemplateBundlePagePrivacyLast: tietosuojakäytäntöömme.
TemplateBundlePageProvideFeedbackCharsLeft: 500 merkkiä jäljellä
TemplateBundlePageProvideFeedbackTooltip: Anna palautetta
TemplateBundlePageSaveAsPDF: Tallenna PDF-tiedostona
TemplateBundlePageSavePDFTooltip: Tallenna PDF-tiedostona
TemplateBundlePageSaveSelectedTopic: Tallenna valittu aihe
TemplateBundlePageSaveSelectedTopicAndSubtopics: Tallenna valittu aihe ja sen aliaiheet
TemplateBundlePageSeeAlso: Katso myös
TemplateBundlePageSend: Lähetä
TemplateBundlePageSendLink: Lähetä
TemplateBundlePageSendLinkTooltip: Lähetä linkki aiheeseen
TemplateBundlePageSubmit: Lähetä
TemplateBundlePageWasThisInformationHelpful: Oliko näistä tiedoista hyötyä?
TemplateBundlePageYEs: Kyllä
TemplateBundlesDeleteLanguage: Poista kieli
TemplateBundlesDeleteManual: Poista käyttöopas
TemplateBundlesDownload: Lataa paketti
TemplateBundlesDownloadClassification: Lataa luokittelun XML
TemplateBundlesHiddenBundle: Piilotettu käyttöopas
TemplateBundlesSearchManuals: Hae käyttöoppaita
TemplateBundlesUploadClassification: Lähetä luokittelun XML
TemplateClassificationForManual: Käyttöoppaalle
TemplateClassificationUploadClassificationMap: Lähetä luokittelukartan XML
TemplateClassificationWarnReindex: HUOMAUTUS: Uuden luokittelukartan lähettäminen aiheuttaa koko sivuston uudelleenindeksoinnin. Tämä voi kestää useita minuutteja.
TemplateContentRolesCRGroups: Sisältörooliryhmät
TemplateContentRolesDefineNewCR: Määritä uusi sisältörooli
TemplateDefaultLayoutAdministration: Hallinta
TemplateDefaultLayoutArticles: Artikkelit
TemplateDefaultLayoutBrowseDocumentation: Selaa
TemplateDefaultLayoutDocumentation: Dokumentaatiokirjasto
TemplateDefaultLayoutHome: Etusivu
TemplateDefaultLayoutLanguages: United States - English
TemplateDefaultLayoutLinksCareers: Työpaikat
TemplateDefaultLayoutLinksContactUs: Ota yhteyttä
TemplateDefaultLayoutLinksIntelCorp: © Intel Corporation
TemplateDefaultLayoutLinksLegalContractsandTerms: Oikeudelliset sopimukset ja ehdot
TemplateDefaultLayoutLinksLegalNotices: Oikeudelliset huomautukset  
TemplateDefaultLayoutLinksPrivacy: Yksityisyys
TemplateDefaultLayoutLinksSiteMap: Sivustokartta
TemplateDefaultLayoutLinksWebsiteFeedback: Sivuston palaute
TemplateDefaultLayoutLogout: Kirjaudu ulos
TemplateDefaultLayoutProfile: Profiili
TemplateDefaultLayoutVideos: Videot
TemplateFilterCurrentPublication: Nykyinen julkaisu
TemplateRequestResetPasswordEmail: Sähköposti
TemplateRequestResetPasswordSubmit: Pyydä salasanan palautussähköpostia
TemplateSearchCurrentPublication name@Text: Nykyinen haku on rajoitettu julkaisuun '#{name}'
TemplateSearchPageClearTooltip: Tyhjennä suodatin
TemplateSearchPageFirstPageTooltip: Siirry ensimmäiselle sivulle
TemplateSearchPageLastPageTooltip: Siirry viimeiselle sivulle
TemplateSearchPageNextPageTooltip: Siirry seuraavalle sivulle
TemplateSearchPagePrevPageTooltip: Siirry edelliselle sivulle
TemplateSearchPublicationTitle: Julkaisu
TemplateSearchSortbyCreatedAsc: Luontipäivä – nouseva
TemplateSearchSortbyCreatedDec: Luontipäivä – laskeva
TemplateSearchSortbyScore: Tulos
TemplateSearchSortbyUpdatedAsc: Lisäyspäivä – nouseva
TemplateSearchSortbyUpdatedDec: Lisäyspäivä – laskeva
TemplateSearchSortbyViews: Katselukertojen määrä
TemplatesSearchPageClear: Tyhjennä
TemplatesSearchPageCurrentResultsFirst: Tulokset 
TemplatesSearchPageCurrentResults: of
TemplatesSearchPageRefilneResults: Tarkenna tuloksia
TemplatesSearchPageResultUpdated: Päivitetty
TemplateUploadSitemapDisable: Poista sivustokartta käytöstä
TemplateUploadSitemapDisabled: Sivustokartta on poistettu käytöstä
TemplateUploadSitemapDisabledWord: Ei käytössä
TemplateUploadSitemapDownloadSitemap: Lataa sivustokartta.xml
TemplateUploadSitemapEnable: Ota sivustokartta käyttöön
TemplateUploadSitemapEnabled: Sivustokartta on otettu käyttöön
TemplateUploadSitemapEnabledWord: Käytössä
TemplateUploadSitemapLegend: Lähetä sivustokartta.xml
TemplateUploadSitemapStatus sts@Text: Sivustokartta on #{sts}
TextPass txt@Text: #{txt}
Upload: Lähetä
UploadLink: Lähetä julkaisu
YesodAuthStormPathSSOErrorOccured: Virhe
YesodAuthStormPathSSOLoginParamError: SSO-kirjautumisparametrivirhe
YesodAuthStormPathSSOLoginTryAgain: Yritä kirjautua uudelleen tunnuksella