AdvancedSearch: Recherche avancée 
AdvancedSearchTooltip: Sélectionner les filtres de contenu
BreadcrumbsProductDocumentationHome: Page d'accueil de la documentation sur les produits
BreadcrumbsSearch: Rechercher
Cancel: Annuler
Close: Fermer
DeleteText: Supprimer
ErrorOccured: Une erreur s'est produite
FilterUsers: Filtrer les utilisateurs :
FoundationLoginOnly: Se connecter
FoundationLoginRegister: Se connecter/S'enregistrer
HandlerAdminOnlyAdmin: Accès refusé
HandlerBundlePageAltCSHResult: Autre rubrique CSH trouvée
HandlerCategoriesCategoryXMLFileUploaded: Fichier XML de catégorie chargé
HandlerClassificationUpdated: Mappage de classification mis à jour
HandlerClassificationXMLFile: Mappage de classification mis à jour
HandlerCommentsComments: commentaires
HandlerCommentsOneComment: 1 commentaire
HandlerCommentsPostedCommentOn: a publié un commentaire sur :
HandlerContentRolesAreYouSureDelete: Voulez-vous vraiment supprimer ce rôle de contenu ?
HandlerContentRolesCRDeleted: Rôle de contenu supprimé
HandlerContentRolesErrorDeleting: Un problème est survenu. Le rôle de contenu n'a pas été supprimé.
HandlerCshAlternateCSHTopicFound: Autre rubrique CSH trouvée
HandlerCshCSHRulesUpdated: Règles CSH mises à jour
HandlerCshInvalidAliases: Clés d'alias non valides trouvées dans l'URL CSH
HandlerCshInvalidCSHRulesFile: Fichier de règles CSH non valide
HandlerCshNewCshFile: Charger un nouveau fichier de configuration CSH
HandlerCshReservedAliasesUsed: Alias réservés utilisés dans le fichier de configuration CSH
HandlerCustomError400H2: 400
HandlerCustomError400H3: Demande incorrecte
HandlerCustomError401H2: 401
HandlerCustomError401H3: Non autorisé
HandlerCustomError403H2: 403
HandlerCustomError403H3: Interdit
HandlerCustomError404H2: 404
HandlerCustomError404H3: Introuvable
HandlerCustomError405H2: 405
HandlerCustomError405H3: Méthode non autorisée
HandlerCustomError500H2: 500
HandlerCustomError500H3: Erreur de serveur interne
HandlerFontoDocumentSaved: Document enregistré
HandlerFontoErrorGeneratingUUID: Erreur lors de la génération de l'UUID
HandlerFontoErrorParsingID: Erreur lors de l'analyse de l'ID
HandlerFontoErrorParsingXML: Erreur lors de l'analyse du contenu XML
HandlerFontoErrorParsingXMLToDocument: Erreur lors de la conversion du fichier XML au format de sortie
HandlerFontoNoFileFound: Fichier introuvable
HandlerFontoNoIDFound: ID introuvable
HandlerFontoUntitledFromCursor: Sans titre – à partir du curseur
HandlerGroupsErrorReadingGroupID: Erreur lors de la lecture de l'ID de groupe
HandlerGroupsGroupUpdated: Groupe mis à jour
HandlerGroupsMustUseUniqueGroupName: Doit utiliser un nom de groupe unique
HandlerGroupsNoGroupNameFound: Aucun nom de groupe n'a été trouvé
HandlerGroupsUnableAssignRole: Rôle impossible à affecter
HandlerHowtoContent: Contenu
HandlerHowtoDeleted: Article supprimé
HandlerHowtoInsufficientPermissions: Autorisations insuffisantes pour modifier cet article
HandlerHowtoSaved: Enregistré
HandlerHowtoTitle: Titre
HandlerHtmlEmptyMyDocs: MyDocs vide
HandlerLangDefaultLanguageCodeFileUpdated: Fichier de code de langue par défaut mis à jour
HandlerLangNewLangFile: Charger un nouveau fichier de code de langue par défaut
HandlerMyPubSourcePublication: Publication de la source
HandlerProfileDisplayName: Nom d'affichage
HandlerProfileScreenName: Pseudonyme
HandlerProfileUpdated: Profil mis à jour
HandlerProfileUsernameInUse: Le nom d'utilisateur existe déjà
HandlerRatingsInvalidRating: Evaluation non valide
HandlerRatingsRatingRecorded: Votre évaluation a été enregistrée
HandlerRatingsRatingUpdated: Votre évaluation a été mise à jour
HandlerRolesErrorReadingRoleID: Erreur lors de la lecture de l'ID de rôle
HandlerRolesMustUseUniqueRoleName: Utiliser un nom de rôle unique
HandlerRolesNoRoleNameFound: Aucun nom de rôle n'a été trouvé
HandlerRolesNotEnoughAdminUsersRemaining: Utilisateurs impossibles à affecter
HandlerRolesSelectedPermissionsLessThenDefault: Autorisations impossibles à affecter : les autorisations sélectionnées sont inférieures à l'ensemble d'autorisations par défaut
HandlerSearchAllResults: Tous les résultats
HandlerSearchNoResults: Aucun résultat
HandlerSearchOneResult: Un résultat
HandlerSitemapFile: Fichier de plan du site
HandlerSitemapFileUploaded: Le plan du site a été mis à jour.
HandlerSubjectSchemeInvalidSubjectSchemeLocalizationFile: Fichier de localisation du schéma d'objet non valide
HandlerSubjectSchemeLangDeleted lang@Text: Fichier de localisation #{lang} supprimé
HandlerSubjectSchemeLangsAvailable: Langues disponibles
HandlerSubjectSchemeLangsDeleteConfirm: Voulez-vous vraiment supprimer le fichier de localisation ? 
HandlerSubjectSchemeLangsDeleteError: Erreur lors de la suppression du fichier de localisation.
HandlerSubjectSchemeLangsNewFile: Charger le fichier de localisation du nouveau schéma d'objet
HandlerSubjectSchemeLangUpdated lang@Text: Fichier de localisation #{lang} mis à jour
HandlerSubjectSchemeLangUploaded lang@Text: Fichier de localisation #{lang} chargé 
HandlerSubjectSchemeProblemOccurredWhileUploadingSubjectScheme: Un problème est survenu lors du chargement du schéma d'objet.
HandlerSubjectSchemeSubjectSchemeUploadedSuccessfully: Le schéma d'objet a été chargé
HandlerSubjectSchemeUnknownLanguageCode: Code de langue inconnu
HandlerSubjectSchemeUpdated: Schéma d'objet mis à jour
HandlerSubjectSchemeXMLFile: Fichier XML du schéma d'objet
HandlerUploadBundleBundle: offre groupée
HandlerUploadBundleDeleteError x@Text: Erreur lors de la suppression de #{x}
HandlerUploadBundleDeleteSuccess x@Text: #{x} a été supprimé(e)
HandlerUploadBundleError: Erreur
HandlerUploadBundleErrorPleaseUpdateSuiteBundleVersion: Erreur - Mettez à jour la version de votre offre groupée
HandlerUploadBundleNoContentToDelete x@Text: Aucun contenu à supprimer dans #{x} 
HandlerUploadBundleOneBundleError: Erreur lors de la spécification de l'offre groupée chargée
HandlerUploadBundlePublicationUploadedSuccessfully: La publication a été chargée
HandlerUploadBundleSheaf: sheaf
HandlerUsersAddedSuccess: L'utilisateur a été ajouté
HandlerUsersBadEmail: Cette adresse e-mail n'a pas été enregistrée
HandlerUsersCRCreated: Groupe de rôles de contenu créé
HandlerUsersCRGroupNameInUse: Le nom de rôle de contenu est déjà utilisé
HandlerUsersCRSetGroupName: Attribuez un nom à ce groupe de rôles de contenu
HandlerUsersCRUpdated: Groupe de rôles de contenu mis à jour
HandlerUsersDefineCR: Définir le groupe de rôles de contenu
HandlerUsersDeleteSuccess: L'utilisateur a été supprimé
HandlerUsersEmailError: Erreur lors de l'envoi de l'e-mail de réinitialisation du mot de passe
HandlerUsersInvalidToken: Jeton non valide
HandlerUsersNoResetToken: Aucun jeton de réinitialisation
HandlerUsersNoRoleIdFound: Aucun ID de rôle n'a été trouvé
HandlerUsersPasswordEmailSent: E-mail de réinitialisation du mot de passe envoyé
HandlerUsersRegisterSuccess: L'utilisateur a été enregistré
HandlerUsersResetPasswordError: Erreur lors de la réinitialisation du mot de passe
HandlerUsersRolesUpdated: Rôles d'utilisateur mis à jour
HandlerUsersUnableToAssignUserPermissionRole: Rôle d'autorisation utilisateur impossible à affecter
HandlerUsersUnknownError: Erreur inconnue
HideTOC: Masquer le sommaire
ImportAddHelperProblemRunningAddHelper: Problème lors de l'exécution d'addHelper
ImportBundlesTooManyTopics num@Int: #{show num} rubriques peuvent être publiées au maximum. Sélectionnez un nombre inférieur de rubriques et réessayez.
ImportElasticAnalyzerError: - Remarque : erreur d'analyseur personnalisé. Consultez le journal pour plus d'informations. Utilisation de l'analyseur par défaut. 
ImportElasticErrorRebuilding: Erreur lors de la reconstruction de l'index. Consultez le journal pour plus d'informations.
ImportElasticErrorUpdating: Erreur lors de la mise à jour de l'index. Consultez le journal pour plus d'informations.
ImportElasticIndexRebuilt x@Text: L'index a été reconstruit #{x}
ImportElasticIndexUpdated x@Text: L'index a été mis à jour #{x}
ImportElasticNoPagesFound: Aucune page n'a été trouvée dans la base de données. Réinitialisation de l'index.
ImportElasticNoPagesInBundle: Aucune page n'a été trouvée dans le chargement
ImportInvalidPassword: Mot de passe non valide
ImportRatingsOneRating: 1 évaluation
ImportRatingsRatings: Évaluations
ImportRolesPermissionDenied: Autorisation refusée
ImportSearchNoCategoriesUploaded: Aucun fichier XML de catégorie n'a été chargé
ImportSearchUnknownTopicLink: *** lien de rubrique inconnu ***
ImportUsersCaptchaError: reCAPTCHA non valide 
ImportUsersCaptchaParseError: Erreur de reCAPTCHA
ImportUsersEmailFieldError: Aucun champ d'e-mail n'a été trouvé.
ImportUsersFldEmail: Adresse e-mail
ImportUsersFldFirstName: Prénom
ImportUsersFldLastName: Nom
ImportUsersFldPassword: Mot de passe
ImportUsersFldReenterPass: Saisir de nouveau le mot de passe
ImportUsersInvalidPass: Mot de passe non valide : le mot de passe sélectionné doit contenir au moins huit caractères, et comprendre au moins une majuscule, une minuscule, un caractère spécial et un chiffre.
LoggedInAs email@Text: Connecté(e) en tant que #{email}.
Manuals: Manuels
PDFPage: Page
ProductDocumentationSplashTitle: Documentation sur les produits 
PublishHowto: Publier
ResultsPerPage: Résultats par page
ResultsPerPageShow: Afficher xx par page
Search: Rechercher dans la documentation sur les produits
SearchContent: Rechercher dans ce contenu
SearchHome: Rechercher dans la documentation sur les produits
ShowTOC: Afficher le sommaire
SSOLoginParamError: Les paramètres de connexion SSO sont incorrects
SSOLoginTryAgain: Essayez de vous reconnecter avec
SwitchLang: Modifier la langue
TemplaesBundlesTitle: Bibliothèque de documentation
TemplateAddHelperCancel: Annuler
TemplateAddHelperSave: Enregistrer
TemplateAddHelperSaveAndClose: Enregistrer et fermer
TemplateAddUserAddUser: Ajouter un utilisateur
TemplateAddUserCancel: Annuler
TemplateAddUserPasswordMessage: Le mot de passe doit contenir au moins huit caractères, et comprendre au moins une majuscule, une minuscule, un caractère spécial et un chiffre.
TemplateAdminArticleManagement: Gestion des articles
TemplateAdminContentRoleGroups: Groupes de rôles de contenu
TemplateAdminCSHConfigFile: Télécharger ou mettre à jour le fichier de configuration CSH
TemplateAdminElasticReindex: Reconstruire l'index de recherche
TemplateAdminExportComments: Exporter les commentaires
TemplateAdminExportRatings: Exporter les évaluations
TemplateAdminManageManuals: Gérer les manuels
TemplateAdminManageResourceManuals: Gérer les packages de ressources
TemplateAdminResourceIdCsv: Télécharger le fichier Excel des ID de ressource
TemplateAdminSitemap: Gérer le plan du site
TemplateAdminSubjectSchemeLocalization: Gérer la localisation du schéma d'objet
TemplateAdminTitle: Administration
TemplateAdminUploadCategoryXML: Gérer le fichier XML de catégorie
TemplateAdminUploadCategoryXml: Charger un nouveau fichier XML de catégorie
TemplateAdminUploadNewLangFile: Charger un nouveau fichier de code de langue par défaut
TemplateAdminUploadSubjectScheme: Gérer le schéma d'objet
TemplateAdminUserGroups: Groupes d'utilisateurs
TemplateAdminUserManagement: Gestion des utilisateurs
TemplateAdminUserRoles: Rôles d'utilisateur
TemplateBundlePageCollapse: Réduire
TemplateBundlePageCollapseTooltip: Réduire tous les titres
TemplateBundlePageComments: Commentaires
TemplateBundlePageContents: Sommaire
TemplateBundlePageExpand: Développer
TemplateBundlePageExpandTooltip: Etendre le sommaire
TemplateBundlePageFeedback: Commentaires
TemplateBundlePageFeedbackThankYou: Merci. Vos commentaires ont été envoyés. 
TemplateBundlePageFeedbackTooltip: Envoyer des commentaires
TemplateBundlePageFilterTitle: Sélectionner une ou plusieurs options
TemplateBundlePageNext: Suivant
TemplateBundlePageNextTopicTooltip: Accéder à la rubrique suivante
TemplateBundlePageNo: Non
TemplateBundlePagePrevious: Précédent 
TemplateBundlePagePrevTopicTooltip: Accéder à la rubrique précédente
TemplateBundlePagePrint: Imprimer
TemplateBundlePagePrintTooltip: Imprimer la rubrique
TemplateBundlePagePrivacy: Afin de garantir la confidentialité de vos informations personnelles, veuillez ne pas inclure vos coordonnées dans vos commentaires. Lisez notre politique de confidentialité.
TemplateBundlePageProvideFeedbackTooltip: Fournir des commentaires
TemplateBundlePageSaveAsPDF: Enregistrer au format PDF
TemplateBundlePageSavePDFTooltip: Enregistrer au format PDF
TemplateBundlePageSaveSelectedTopic: Enregistrer la rubrique sélectionnée
TemplateBundlePageSaveSelectedTopicAndSubtopics: Enregistrer la rubrique et les sous-rubriques sélectionnées
TemplateBundlePageSeeAlso: Voir aussi
TemplateBundlePageSend: Envoyer
TemplateBundlePageSendLink: Envoyer
TemplateBundlePageSendLinkTooltip: Envoyer le lien vers la rubrique
TemplateBundlePageSubmit: Envoyer
TemplateBundlePageWasThisInformationHelpful: Ces informations vous ont-elles été utiles ?
TemplateBundlePageYEs: Oui
TemplateBundlesDeleteLanguage: Supprimer la langue
TemplateBundlesDeleteManual: Supprimer le manuel
TemplateBundlesDownload: Télécharger l'offre groupée
TemplateBundlesDownloadClassification: Télécharger le fichier XML de classification
TemplateBundlesHiddenBundle: Manuel masqué
TemplateBundlesSearchManuals: Rechercher dans les manuels
TemplateBundlesUploadClassification: Charger le fichier XML de classification
TemplateClassificationForManual: Pour le manuel
TemplateClassificationUploadClassificationMap: Charger le fichier XML de mappage de classification
TemplateClassificationWarnReindex: REMARQUE : le chargement d'un mappage de classification entraînera la réindexation de la totalité du site. L'opération peut prendre plusieurs minutes.
TemplateContentRolesCRGroups: Groupes de rôles de contenu
TemplateContentRolesDefineNewCR: Définir un nouveau rôle de contenu
TemplateDefaultLayoutAdministration: Administration
TemplateDefaultLayoutArticles: Articles
TemplateDefaultLayoutBrowseDocumentation: Parcourir
TemplateDefaultLayoutDocumentation: Bibliothèque de documentation
TemplateDefaultLayoutHome: Accueil
TemplateDefaultLayoutLanguages: United States - English
TemplateDefaultLayoutLinksCareers: Opportunités d'emploi
TemplateDefaultLayoutLinksContactUs: Nous contacter
TemplateDefaultLayoutLinksIntelCorp: © Intel Corporation
TemplateDefaultLayoutLinksLegalContractsandTerms: Conditions des contrats et dispositions légales
TemplateDefaultLayoutLinksLegalNotices: Mentions légales  
TemplateDefaultLayoutLinksSiteMap: Plan du site
TemplateDefaultLayoutLinksWebsiteFeedback: Commentaires sur le site web
TemplateDefaultLayoutLogout: Se déconnecter
TemplateDefaultLayoutProfile: Profil
TemplateDefaultLayoutVideos: Vidéos
TemplateFilterCurrentPublication: Publication actuelle
TemplateRequestResetPasswordEmail: E-mail
TemplateRequestResetPasswordSubmit: E-mail de demande de réinitialisation du mot de passe
TemplateSearchCurrentPublication name@Text: La recherche actuelle est limitée à la publication '#{name}'
TemplateSearchPageClearTooltip: Effacer les filtres
TemplateSearchPageFirstPageTooltip: Accéder à la première page
TemplateSearchPageLastPageTooltip: Accéder à la dernière page
TemplateSearchPageNextPageTooltip: Accéder à la page suivante
TemplateSearchPagePrevPageTooltip: Accéder à la page précédente
TemplateSearchPublicationTitle: Publication
TemplateSearchSortbyCreatedAsc: Date de création - Ordre croissant
TemplateSearchSortbyCreatedDec: Date de création - Ordre décroissant
TemplateSearchSortbyScore: Score
TemplateSearchSortbyUpdatedAsc: Date d'ajout - Ordre croissant
TemplateSearchSortbyUpdatedDec: Date d'ajout - Ordre décroissant
TemplateSearchSortbyViews: Nombre de consultations
TemplatesSearchPageClear: Effacer
TemplatesSearchPageCurrentResults: Résultats xx-yy sur zzz
TemplatesSearchPageRefilneResults: Affiner les résultats
TemplatesSearchPageResultUpdated: Mis à jour
TemplateUploadSitemapDisable: Désactiver le plan du site
TemplateUploadSitemapDisabled: Plan du site désactivé
TemplateUploadSitemapDisabledWord: Désactivé
TemplateUploadSitemapDownloadSitemap: Télécharger le fichier sitemap.xml
TemplateUploadSitemapEnable: Activer le plan du site
TemplateUploadSitemapEnabled: Plan du site activé
TemplateUploadSitemapEnabledWord: Activé
TemplateUploadSitemapLegend: Charger le fichier sitemap.xml
TemplateUploadSitemapStatus sts@Text: Le plan du site est #{sts}
TemplTemplateBundlePageProvideFeedbackTooltip: Envoyer des commentaires
TextPass txt@Text: #{txt}
Upload: Charger
UploadLink: Charger une publication
YesodAuthStormPathSSOErrorOccured: Une erreur s'est produite
YesodAuthStormPathSSOLoginParamError: Les paramètres de connexion SSO sont incorrects
YesodAuthStormPathSSOLoginTryAgain: Essayez de vous reconnecter avec