AdvancedSearch: Ricerca avanzata 
AdvancedSearchTooltip: Seleziona filtri del contenuto
BreadcrumbsProductDocumentationHome: Home page Documentazione del prodotto
BreadcrumbsSearch: Ricerca
Cancel: Annulla
Close: Chiudi
DeleteText: Elimina
ErrorOccured: Si è verificato un errore
FilterUsers: Filtra utenti:
FoundationLoginOnly: Accedi
FoundationLoginRegister: Accedi/Effettua la registrazione
HandlerAdminOnlyAdmin: Accesso negato
HandlerBundlePageAltCSHResult: Trovato argomento CSH aternativo
HandlerCategoriesCategoryXMLFileUploaded: File XML delle categorie caricato
HandlerClassificationUpdated: Mappa di classificazione aggiornata
HandlerClassificationXMLFile: Mappa di classificazione aggiornata
HandlerCommentsComments: commenti
HandlerCommentsOneComment: 1 commento
HandlerCommentsPostedCommentOn: ha pubblicato un commento su:
HandlerContentRolesAreYouSureDelete: Eliminare il ruolo di contenuto?
HandlerContentRolesCRDeleted: Ruolo di contenuto eliminato
HandlerContentRolesErrorDeleting: Si è verificato un problema. Il ruolo di contenuto non è stato eliminato.
HandlerCshAlternateCSHTopicFound: Trovato argomento CSH alternativo
HandlerCshCSHRulesUpdated: Regole CSH aggiornate
HandlerCshInvalidAliases: Chiavi alias non valide trovate nell'URL CSH
HandlerCshInvalidCSHRulesFile: File di regole CSH non valido
HandlerCshNewCshFile: Carica nuovo file di configurazione CSH
HandlerCshReservedAliasesUsed: Alias riservati utilizzati nel file di configurazione CSH
HandlerCustomError400H2: 400
HandlerCustomError400H3: Richiesta non valida
HandlerCustomError401H2: 401
HandlerCustomError401H3: Utente non autorizzato
HandlerCustomError403H2: 403
HandlerCustomError403H3: Proibito
HandlerCustomError404H2: 404
HandlerCustomError404H3: Non trovato
HandlerCustomError405H2: 405
HandlerCustomError405H3: Metodo non consentito
HandlerCustomError500H2: 500
HandlerCustomError500H3: Errore interno del server
HandlerFontoDocumentSaved: Documento salvato
HandlerFontoErrorGeneratingUUID: Errore durante la generazione dell'UUID
HandlerFontoErrorParsingID: Errore durante l'analisi dell'ID
HandlerFontoErrorParsingXML: Errore durante l'analisi di XML
HandlerFontoErrorParsingXMLToDocument: Errore durante l'analisi di XML in un documento
HandlerFontoNoFileFound: File non trovato.
HandlerFontoNoIDFound: ID non trovato
HandlerFontoUntitledFromCursor: Senza titolo - Dal cursore
HandlerGroupsErrorReadingGroupID: Errore di lettura dell'ID del gruppo
HandlerGroupsGroupUpdated: Gruppo aggiornato
HandlerGroupsMustUseUniqueGroupName: È necessario utilizzare un nome di gruppo univoco
HandlerGroupsNoGroupNameFound: Nessun nome di gruppo trovato
HandlerGroupsUnableAssignRole: Impossibile assegnare il ruolo
HandlerHowtoContent: Contenuto
HandlerHowtoDeleted: Articolo eliminato
HandlerHowtoInsufficientPermissions: Autorizzazioni non sufficienti per modificare questo articolo
HandlerHowtoSaved: Salvato
HandlerHowtoTitle: Titolo
HandlerHtmlEmptyMyDocs: I miei documenti vuoto
HandlerLangDefaultLanguageCodeFileUpdated: File del codice della lingua predefinita caricato
HandlerLangNewLangFile: Carica nuovo file col codice della lingua predefinita
HandlerMyPubSourcePublication: Pubblicazione di origine
HandlerProfileDisplayName: Nome visualizzato
HandlerProfileScreenName: Nome schermata
HandlerProfileUpdated: Profilo aggiornato
HandlerProfileUsernameInUse: Il nome utente esiste
HandlerRatingsInvalidRating: Classificazione non valida
HandlerRatingsRatingRecorded: La classificazione è stata registrata
HandlerRatingsRatingUpdated: La classificazione è stata aggiornata
HandlerRolesErrorReadingRoleID: Errore di lettura dell'ID del ruolo
HandlerRolesMustUseUniqueRoleName: Utilizzare un nome di ruolo univoco
HandlerRolesNoRoleNameFound: Nessun nome di ruolo trovato
HandlerRolesNotEnoughAdminUsersRemaining: Impossibile assegnare utenti
HandlerRolesSelectedPermissionsLessThenDefault: Impossibile assegnare autorizzazioni: le autorizzazioni selezionate sono inferiori al set di autorizzazioni predefinito
HandlerSearchAllResults: Tutti i risultati
HandlerSearchNoResultsMsgTryFollowing: Nessun risultato trovato. Provare quanto segue:
HandlerSearchNoResultsMsgSpelledCorrectly: Assicurarsi che tutte le parole siano state digitate correttamente.
HandlerSearchNoResultsMsgTryDifferent: Prova parole chiave diverse.
HandlerSearchNoResultsMsgMoreGeneral: Prova parole chiave più generiche.
HandlerSearchNoResultsMsgNoFindProdVer: Non trovare il prodotto o la versione? Vai alla Intel Security ServicePortal.
HandlerSearchNoResults: Nessun risultato
HandlerSearchOneResult: Un risultato
HandlerSitemapFile: File della mappa del sito
HandlerSitemapFileUploaded: Mappa del sito aggiornata.
HandlerSubjectSchemeInvalidSubjectSchemeLocalizationFile: File di localizzazione dello schema dell'oggetto non valido
HandlerSubjectSchemeLangDeleted lang@Text: #{lang} Eliminato il file di localizzazione
HandlerSubjectSchemeLangsAvailable: Lingue disponibili
HandlerSubjectSchemeLangsDeleteConfirm: Eliminare il file di localizzazione? 
HandlerSubjectSchemeLangsDeleteError: Errore durante l'eliminazione del file di localizzazione.
HandlerSubjectSchemeLangsNewFile: Carica nuovo file di localizzazione dello schema dell'oggetto
HandlerSubjectSchemeLangUpdated lang@Text: #{lang} File di localizzazione aggiornato
HandlerSubjectSchemeLangUploaded lang@Text: #{lang} File di localizzazione caricato 
HandlerSubjectSchemeProblemOccurredWhileUploadingSubjectScheme: Si è verificato un errore durante il caricamento dello schema dell'oggetto.
HandlerSubjectSchemeSubjectSchemeUploadedSuccessfully: Lo schema dell'oggetto è stato caricato
HandlerSubjectSchemeUnknownLanguageCode: Codice della lingua sconosciuto
HandlerSubjectSchemeUpdated: Schema dell'oggetto aggiornato
HandlerSubjectSchemeXMLFile: File XML con schema dell'oggetto
HandlerUploadBundleBundle: bundle
HandlerUploadBundleDeleteError x@Text: Errore durante l'eliminazione di #{x}
HandlerUploadBundleDeleteSuccess x@Text: Eliminazione di #{x} riuscita
HandlerUploadBundleError: Errore
HandlerUploadBundleErrorPleaseUpdateSuiteBundleVersion: Errore. Aggiornare la versione bundle.
HandlerUploadBundleNoContentToDelete x@Text: Nessun contenuto da eliminare in #{x} 
HandlerUploadBundleOneBundleError: Errore durante la precompilazione del bundle caricato
HandlerUploadBundlePublicationUploadedSuccessfully: Pubblicazione caricata
HandlerUploadBundleSheaf: sheaf
HandlerUsersAddedSuccess: Utente aggiunto
HandlerUsersBadEmail: L'indirizzo email non è registrato
HandlerUsersCRCreated: Gruppo di ruoli di contenuto creato
HandlerUsersCRGroupNameInUse: Il nome del ruolo di contenuto è già in uso
HandlerUsersCRSetGroupName: Impostare un nome per il gruppo di ruoli di contenuto
HandlerUsersCRUpdated: Gruppo di ruoli di contenuto aggiornato
HandlerUsersDefineCR: Definisci nuovo gruppo di ruoli di contenuto
HandlerUsersDeleteSuccess: Utente eliminato
HandlerUsersEmailError: Errore di invio dell'email di reimpostazione della password
HandlerUsersInvalidToken: Token non valido
HandlerUsersNoResetToken: Nessun token reimpostato
HandlerUsersNoRoleIdFound: Nessun ID del ruolo trovato
HandlerUsersPasswordEmailSent: Email di reimpostazione della password inviata
HandlerUsersRegisterSuccess: Utente registrato
HandlerUsersResetPasswordError: Errore durante la reimpostazione della password
HandlerUsersRolesUpdated: Ruoli utente aggiornati
HandlerUsersUnableToAssignUserPermissionRole: Impossibile assegnare il ruolo di autorizzazione dell'utente
HandlerUsersUnknownError: Errore sconosciuto
HideTOC: Nascondi sommario
ImportAddHelperProblemRunningAddHelper: Problema durante l'esecuzione di addHelper
ImportBundlesTooManyTopics num@Int: È possibile pubblicare un numero massimo di #{show num} argomenti. Selezionare un numero inferiore di argomenti e riprovare.
ImportElasticAnalyzerError: - Nota: errore dell'analizzatore personalizzato. Vedere il registro per i dettagli. Verrà utilizzato l'analizzatore predefinito. 
ImportElasticErrorRebuilding: Errore di ricompilazione dell'indice. Vedere il registro per ulteriori dettagli.
ImportElasticErrorUpdating: Errore di aggiornamento dell'indice. Vedere il registro per ulteriori dettagli.
ImportElasticIndexRebuilt x@Text: Indice ricompilato #{x}
ImportElasticIndexUpdated x@Text: Indice aggiornato #{x}
ImportElasticNoPagesFound: Nessuna pagina trovata nel database. Indice reimpostato.
ImportElasticNoPagesInBundle: Nessuna pagina trovata nel caricamento
ImportInvalidPassword: Password non valida
ImportRatingsOneRating: 1. Classificazione
ImportRatingsRatings: Classificazioni
ImportRolesPermissionDenied: Autorizzazione negata
ImportSearchNoCategoriesUploaded: Nessun file XML delle categorie caricato
ImportSearchUnknownTopicLink: *** collegamento ad argomento sconosciuto ***
ImportUsersCaptchaError: reCAPTCHA non valido 
ImportUsersCaptchaParseError: Errore reCAPTCHA
ImportUsersEmailFieldError: Nessun campo email trovato.
ImportUsersFldEmail: Email
ImportUsersFldFirstName: Nome
ImportUsersFldLastName: Cognome
ImportUsersFldPassword: Password
ImportUsersFldReenterPass: Reimmetti la password
ImportUsersInvalidPass: Password non valida: la password deve essere composta da almeno otto caratteri, tra cui almeno una lettera maiuscola, una lettera minuscola, un carattere speciale e un numero
LoggedInAs email@Text: Accesso effettuato come #{email}.
Manuals: Manuali
PDFPage: Pagina
ProductDocumentationSplashTitle: Documentazione del prodotto 
PublishHowto: Pubblica
ResultsPerPage: Risultati per pagina
ResultsPerPageShowFirst: Mostra
ResultsPerPageShow: per pagina
Search: Cerca in documentazione del prodotto
SearchContent: Cerca in questo contenuto
SearchHome: Cerca in documentazione del prodotto
ShowTOC: Mostra sommario
SSOLoginParamError: Si è verificato un errore con i parametri di accesso SSO
SSOLoginTryAgain: Prova effettuare di nuovo l'accesso con
SwitchLang: Modifica lingua
TemplaesBundlesTitle: Libreria dei documenti
TemplateAddHelperCancel: Annulla
TemplateAddHelperSave: Salva
TemplateAddHelperSaveAndClose: Salva e chiudi
TemplateAddUserAddUser: Aggiungi utente
TemplateAddUserCancel: Annulla
TemplateAddUserPasswordMessage: La password deve essere composta da almeno otto caratteri, tra cui almeno una lettera maiuscola, una lettera minuscola, un carattere speciale e un numero.
TemplateAdminArticleManagement: Gestione articoli
TemplateAdminContentRoleGroups: Gruppi di ruoli di contenuto
TemplateAdminCSHConfigFile: Scarica o aggiorna il file di configurazione CSH
TemplateAdminElasticReindex: Ricrea indice di ricerca
TemplateAdminExportComments: Esporta commenti
TemplateAdminExportRatings: Esporta classificazioni
TemplateAdminManageManuals: Gestisci manuali
TemplateAdminManageResourceManuals: Gestisci pacchetti di risorse
TemplateAdminResourceIdCsv: Scarica il file Excel ResourceIds
TemplateAdminSitemap: Gestisci mappa del sito
TemplateAdminSubjectSchemeLocalization: Gestisci localizzazione schema dell'oggetto
TemplateAdminTitle: Amministrazione
TemplateAdminUploadCategoryXML: Gestisci il file XML delle categorie
TemplateAdminUploadCategoryXml: Carica un nuovo file XML delle categorie
TemplateAdminUploadNewLangFile: Carica un nuovo file del codice della lingua predefinita
TemplateAdminUploadSubjectScheme: Gestisci schema dell'oggetto
TemplateAdminUserGroups: Gruppi di utenti
TemplateAdminUserManagement: Gestione degli utenti
TemplateAdminUserRoles: Ruoli utente
TemplateBundlePageCollapse: Comprimi
TemplateBundlePageCollapseTooltip: Comprimi tutti i titoli
TemplateBundlePageComments: Commenti
TemplateBundlePageContents: Contenuto
TemplateBundlePageExpand: Espandi
TemplateBundlePageExpandTooltip: Espandi sommario
TemplateBundlePageFeedback: Commenti
TemplateBundlePageFeedbackThankYou: Grazie! I commenti sono stati inviati. 
TemplateBundlePageFeedbackTooltip: Invia commento
TemplateBundlePageFilterTitle: Selezionare una o più opzioni
TemplateBundlePageNext: Avanti
TemplateBundlePageNextTopicTooltip: Passa all'argomento successivo
TemplateBundlePageNo: No
TemplateBundlePagePrevious: Precedente 
TemplateBundlePagePrevTopicTooltip: Passa all'argomento precedente
TemplateBundlePagePrint: Stampa
TemplateBundlePagePrintTooltip: Stampa argomento
TemplateBundlePagePrivacy: Per salvaguardare la privacy, non includere informazioni di contatto nel commento. Consulta l'informativa 
TemplateBundlePagePrivacyLast: sulla privacy.
TemplateBundlePageProvideFeedbackCharsLeft: 500 caratteri
TemplateBundlePageProvideFeedbackTooltip: Fornisci commenti
TemplateBundlePageSaveAsPDF: Salva come PDF
TemplateBundlePageSavePDFTooltip: Salva come PDF
TemplateBundlePageSaveSelectedTopic: Salva argomento selezionato
TemplateBundlePageSaveSelectedTopicAndSubtopics: Salva argomento selezionato e argomenti secondari
TemplateBundlePageSeeAlso: Vedere anche
TemplateBundlePageSend: Invia
TemplateBundlePageSendLink: Invia
TemplateBundlePageSendLinkTooltip: Invia collegamento all'argomento
TemplateBundlePageSubmit: Invia
TemplateBundlePageWasThisInformationHelpful: Le informazioni sono state utili?
TemplateBundlePageYEs: Sì
TemplateBundlesDeleteLanguage: Elimina lingua
TemplateBundlesDeleteManual: Elimina manuale
TemplateBundlesDownload: Scarica bundle
TemplateBundlesDownloadClassification: Scarica XML di classificazione
TemplateBundlesHiddenBundle: Manuale nascosto
TemplateBundlesSearchManuals: Cerca manuali
TemplateBundlesUploadClassification: Carica XML di classificazione
TemplateClassificationForManual: Per il manuale
TemplateClassificationUploadClassificationMap: Carica XML con mappa di classificazione
TemplateClassificationWarnReindex: NOTA: se si carica una mappa di classificazione, l'intero sito verrà reindicizzato. Questa operazione può richiedere diversi minuti.
TemplateContentRolesCRGroups: Gruppi di ruoli di contenuto
TemplateContentRolesDefineNewCR: Definisci nuovo ruolo di contenuto
TemplateDefaultLayoutAdministration: Amministrazione
TemplateDefaultLayoutArticles: Articoli
TemplateDefaultLayoutBrowseDocumentation: Sfoglia
TemplateDefaultLayoutDocumentation: Libreria dei documenti
TemplateDefaultLayoutHome: Home page
TemplateDefaultLayoutLanguages: United States - English
TemplateDefaultLayoutLinksCareers: Carriere
TemplateDefaultLayoutLinksContactUs: Contatti
TemplateDefaultLayoutLinksIntelCorp: © Intel Corporation
TemplateDefaultLayoutLinksLegalContractsandTerms: Contratti e termini legali
TemplateDefaultLayoutLinksLegalNotices: Avvisi legali 
TemplateDefaultLayoutLinksPrivacy: Vita privata
TemplateDefaultLayoutLinksSiteMap: Mappa del sito
TemplateDefaultLayoutLinksWebsiteFeedback: Commenti sul sito Web
TemplateDefaultLayoutLogout: Esci
TemplateDefaultLayoutProfile: Profilo
TemplateDefaultLayoutVideos: Video
TemplateFilterCurrentPublication: Pubblicazione corrente
TemplateRequestResetPasswordEmail: Email
TemplateRequestResetPasswordSubmit: Richiedi email di reimpostazione della password
TemplateSearchCurrentPublication name@Text: La ricerca corrente è limitata alla pubblicazione "#{name}"
TemplateSearchPageClearTooltip: Cancella filtri
TemplateSearchPageFirstPageTooltip: Vai alla prima pagina
TemplateSearchPageLastPageTooltip: Vai all'ultima pagina
TemplateSearchPageNextPageTooltip: Vai alla pagina successiva
TemplateSearchPagePrevPageTooltip: Vai alla pagina precedente
TemplateSearchPublicationTitle: Pubblicazione
TemplateSearchSortbyCreatedAsc: Data di creazione - Crescente
TemplateSearchSortbyCreatedDec: Data di creazione - Discendente
TemplateSearchSortbyScore: Punteggio
TemplateSearchSortbyUpdatedAsc: Data di aggiunta - Crescente
TemplateSearchSortbyUpdatedDec: Data di aggiunta - Decrescente
TemplateSearchSortbyViews: Numero di visualizzazioni
TemplatesSearchPageClear: Cancella
TemplatesSearchPageCurrentResultsFirst: Risultati
TemplatesSearchPageCurrentResults: di
TemplatesSearchPageRefilneResults: Filtra i risultati
TemplatesSearchPageResultUpdated: Aggiornato
TemplateUploadSitemapDisable: Disattiva mappa del sito
TemplateUploadSitemapDisabled: Mappa del sito disattivata
TemplateUploadSitemapDisabledWord: Disattivata
TemplateUploadSitemapDownloadSitemap: Scarica il file sitemap.xml
TemplateUploadSitemapEnable: Attiva mappa del sito
TemplateUploadSitemapEnabled: Mappa del sito attivata
TemplateUploadSitemapEnabledWord: Attivata
TemplateUploadSitemapLegend: Carica il file sitemap.xml
TemplateUploadSitemapStatus sts@Text: La mappa del sito è #{sts}
TextPass txt@Text: #{txt}
Upload: Carica
UploadLink: Carica pubblicazione
YesodAuthStormPathSSOErrorOccured: Si è verificato un errore
YesodAuthStormPathSSOLoginParamError: Si è verificato un errore con i parametri di accesso SSO
YesodAuthStormPathSSOLoginTryAgain: Prova effettuare di nuovo l'accesso con