AdvancedSearch: 高度な検索
AdvancedSearchTooltip: コンテンツ フィルターの選択
BreadcrumbsProductDocumentationHome: 製品ドキュメント ホーム
BreadcrumbsSearch: 検索
Cancel: キャンセル
Close: 閉じる
DeleteText: 削除
ErrorOccured: エラーが発生しました
FilterUsers: ユーザーをフィルタリング:
FoundationLoginOnly: ログオン
FoundationLoginRegister: ログオン / 登録
HandlerAdminOnlyAdmin: 拒否されたアクセス
HandlerBundlePageAltCSHResult: 代替の CSH トピックが見つかりました
HandlerCategoriesCategoryXMLFileUploaded: カテゴリ XML ファイルをアップロードしました
HandlerClassificationUpdated: Classification Map を更新しました
HandlerClassificationXMLFile: Classification Map を更新しました
HandlerCommentsComments: 件のコメント
HandlerCommentsOneComment: 1 件のコメント
HandlerCommentsPostedCommentOn: が次にコメントを投稿しました:
HandlerContentRolesAreYouSureDelete: このコンテンツ ロールを削除しますか?
HandlerContentRolesCRDeleted: コンテンツ ロールを削除しました
HandlerContentRolesErrorDeleting: 問題が発生しました。コンテンツ ロールは削除されませんでした。
HandlerCshAlternateCSHTopicFound: 代替の CSH トピックが見つかりました
HandlerCshCSHRulesUpdated: CSH ルールを更新しました
HandlerCshInvalidAliases: 無効なエイリアス キーが CSH URL で見つかりました
HandlerCshInvalidCSHRulesFile: 無効な CSH ルール ファイルです
HandlerCshNewCshFile: 新規の CSH 構成ファイルのアップロード
HandlerCshReservedAliasesUsed: CSH 構成ファイルで使用されている予約済みのエイリアス
HandlerCustomError400H2: 400
HandlerCustomError400H3: 不正なリクエストです
HandlerCustomError401H2: 401
HandlerCustomError401H3: 認証されていません
HandlerCustomError403H2: 403
HandlerCustomError403H3: 禁止されています
HandlerCustomError404H2: 404
HandlerCustomError404H3: 見つかりません
HandlerCustomError405H2: 405
HandlerCustomError405H3: 許可されていないメソッドです
HandlerCustomError500H2: 500
HandlerCustomError500H3: 内部サーバー エラーです
HandlerFontoDocumentSaved: ドキュメントを保存しました
HandlerFontoErrorGeneratingUUID: UUID の生成中にエラーが発生しました
HandlerFontoErrorParsingID: ID の解析中にエラーが発生しました
HandlerFontoErrorParsingXML: XML の解析中にエラーが発生しました
HandlerFontoErrorParsingXMLToDocument: XML からドキュメントへの解析中にエラーが発生しました
HandlerFontoNoFileFound: ファイルが見つかりません
HandlerFontoNoIDFound: ID が見つかりません
HandlerFontoUntitledFromCursor: 無題 - カーソルより
HandlerGroupsErrorReadingGroupID: グループ ID の読み取り中にエラーが発生しました
HandlerGroupsGroupUpdated: グループを更新しました
HandlerGroupsMustUseUniqueGroupName: 一意のグループ名を使用する必要があります
HandlerGroupsNoGroupNameFound: グループ名が見つかりません
HandlerGroupsUnableAssignRole: ロールを割り当てることができません
HandlerHowtoContent: コンテンツ
HandlerHowtoDeleted: 記事を削除しました
HandlerHowtoInsufficientPermissions: この記事を編集するための十分な権限がありません
HandlerHowtoSaved: 保存しました
HandlerHowtoTitle: タイトル
HandlerHtmlEmptyMyDocs: 空の MyDocs です
HandlerLangDefaultLanguageCodeFileUpdated: デフォルトの言語コード ファイルを更新しました
HandlerLangNewLangFile: 新規のデフォルト言語コード ファイルのアップロード
HandlerMyPubSourcePublication: ソース文書
HandlerProfileDisplayName: 表示名
HandlerProfileScreenName: スクリーン名
HandlerProfileUpdated: プロファイルを更新しました
HandlerProfileUsernameInUse: 既存のユーザー名です
HandlerRatingsInvalidRating: 評価が無効です
HandlerRatingsRatingRecorded: 評価が記録されました
HandlerRatingsRatingUpdated: 評価が更新されました
HandlerRolesErrorReadingRoleID: ロール ID の読み取り中にエラーが発生しました
HandlerRolesMustUseUniqueRoleName: 一意のロール名を使用してください
HandlerRolesNoRoleNameFound: ロール名が見つかりません
HandlerRolesNotEnoughAdminUsersRemaining: ユーザーを割り当てることができません
HandlerRolesSelectedPermissionsLessThenDefault: 権限を割り当てることができません。選択された権限はデフォルトの権限セットより権限が少なくなっています
HandlerSearchAllResults: すべての結果
HandlerSearchNoResultsMsgTryFollowing: 結果が見つかりません。次をお試しください:
HandlerSearchNoResultsMsgSpelledCorrectly: スペルに間違いがないことを確認します。
HandlerSearchNoResultsMsgTryDifferent: 別のキーワードを試します。
HandlerSearchNoResultsMsgMoreGeneral: もう少し意味の広い語句を試します。
HandlerSearchNoResultsMsgNoFindProdVer: ご使用の製品またはバージョンが見つからない場合は、Intel Security ServicePortal にアクセスしてください。
HandlerSearchNoResults: 結果なし
HandlerSearchOneResult: 1 つの結果
HandlerSitemapFile: サイトマップ ファイル
HandlerSitemapFileUploaded: サイトマップを正常に更新しました。
HandlerSubjectSchemeInvalidSubjectSchemeLocalizationFile: 無効な Subject Scheme ローカライズ ファイルです
HandlerSubjectSchemeLangDeleted lang@Text: #{lang} のローカライズ ファイルを削除しました
HandlerSubjectSchemeLangsAvailable: 利用可能な言語
HandlerSubjectSchemeLangsDeleteConfirm: ローカライズ ファイルを削除しますか? 
HandlerSubjectSchemeLangsDeleteError: ローカライズ ファイルの削除中にエラーが発生しました。
HandlerSubjectSchemeLangsNewFile: 新規の SubjectScheme ローカライズ ファイルのアップロード
HandlerSubjectSchemeLangUpdated lang@Text: #{lang} のローカライズ ファイルを更新しました
HandlerSubjectSchemeLangUploaded lang@Text: #{lang} のローカライズ ファイルをアップロードしました
HandlerSubjectSchemeProblemOccurredWhileUploadingSubjectScheme: Subject Scheme のアップロード中に問題が発生しました。
HandlerSubjectSchemeSubjectSchemeUploadedSuccessfully: Subject Scheme を正常にアップロードしました
HandlerSubjectSchemeUnknownLanguageCode: 不明な言語コードです
HandlerSubjectSchemeUpdated: Subject Scheme を更新しました
HandlerSubjectSchemeXMLFile: Subject Scheme XML ファイル
HandlerUploadBundleBundle: バンドル
HandlerUploadBundleDeleteError x@Text: #{x} の削除中にエラーが発生しました
HandlerUploadBundleDeleteSuccess x@Text: #{x} を正常に削除しました
HandlerUploadBundleError: エラー
HandlerUploadBundleErrorPleaseUpdateSuiteBundleVersion: エラー - バンドルのバージョンを更新してください
HandlerUploadBundleNoContentToDelete x@Text: #{x} には削除するコンテンツがありません
HandlerUploadBundleOneBundleError: アップロードしたバンドルの設定中にエラーが発生しました
HandlerUploadBundlePublicationUploadedSuccessfully: 文書を正常にアップロードしました
HandlerUploadBundleSheaf: sheaf
HandlerUsersAddedSuccess: ユーザーは正常に追加されました
HandlerUsersBadEmail: このメール アドレスは登録されていません
HandlerUsersCRCreated: コンテンツ ロール グループを作成しました
HandlerUsersCRGroupNameInUse: コンテンツ ロール名はすでに使用されています
HandlerUsersCRSetGroupName: このコンテンツ ロール グループの名前を設定してください
HandlerUsersCRUpdated: コンテンツ ロール グループを更新しました
HandlerUsersDefineCR: 新規コンテンツ ロール グループの定義
HandlerUsersDeleteSuccess: ユーザーを正常に削除しました
HandlerUsersEmailError: パスワード リセットの電子メールの送信中にエラーが発生しました
HandlerUsersInvalidToken: 無効なトークンです
HandlerUsersNoResetToken: リセットされたトークンはありません
HandlerUsersNoRoleIdFound: ロール ID が見つかりません
HandlerUsersPasswordEmailSent: パスワード リセットの電子メールを送信しました
HandlerUsersRegisterSuccess: ユーザーを正常に登録しました
HandlerUsersResetPasswordError: パスワードのリセット中にエラーが発生しました
HandlerUsersRolesUpdated: ユーザーの役割を更新しました
HandlerUsersUnableToAssignUserPermissionRole: ユーザーに権限ロールを割り当てることができません
HandlerUsersUnknownError: 不明なエラー
HideTOC: 目次を非表示にする
ImportAddHelperProblemRunningAddHelper: addHelper の実行中に問題が発生しました
ImportBundlesTooManyTopics num@Int: 公開できるトピックは最大で #{show num} 件までです。トピック数を少なくしてもう一度お試しください。
ImportElasticAnalyzerError: - 注意: カスタム アナライザーでエラーが発生しました。詳しくはログを参照してください。デフォルトのアナライザーを使用しています。
ImportElasticErrorRebuilding: インデックスの再構築中にエラーが発生しました。詳しくはログを参照してください。
ImportElasticErrorUpdating: インデックスの更新中にエラーが発生しました。詳しくはログを参照してください。
ImportElasticIndexRebuilt x@Text: インデックスを正常に再構築しました #{x}
ImportElasticIndexUpdated x@Text: インデックスを正常に更新しました #{x}
ImportElasticNoPagesFound: データベースにページが見つかりません。インデックスをリセットしました。
ImportElasticNoPagesInBundle: アップロード内にページが見つかりません
ImportInvalidPassword: パスワードが無効です
ImportRatingsOneRating: 1 件の評価
ImportRatingsRatings: 件の評価
ImportRolesPermissionDenied: 許可されませんでした
ImportSearchNoCategoriesUploaded: カテゴリ XML ファイルは 1 つもアップロードされませんでした
ImportSearchUnknownTopicLink: *** 不明なトピック リンク ***
ImportUsersCaptchaError: 無効な reCAPTCHA 
ImportUsersCaptchaParseError: reCAPTCHA エラー
ImportUsersEmailFieldError: 電子メール フィールドが見つかりませんでした。
ImportUsersFldEmail: 電子メール
ImportUsersFldFirstName: 名
ImportUsersFldLastName: 姓
ImportUsersFldPassword: パスワード
ImportUsersFldReenterPass: パスワードの再入力
ImportUsersInvalidPass: パスワードが無効です。大文字、小文字、特殊文字、数字をそれぞれ 1 文字以上使用し、8 文字以上のパスワードにしてください。
LoggedInAs email@Text: #{email} でログインしています。
Manuals: マニュアル
PDFPage: ページ
ProductDocumentationSplashTitle: 製品ドキュメント
PublishHowto: 公開
ResultsPerPage: 1 ページに表示する結果の件数
ResultsPerPageShowFirst: 表示
ResultsPerPageShow: 件/ページ
Search: 製品ドキュメントを検索する
SearchContent: このコンテンツを検索する
SearchHome: 製品ドキュメントを検索する
ShowTOC: 目次を表示する
SSOLoginParamError: SSO ログイン パラメーターにエラーがありました
SSOLoginTryAgain: 次を使用してもう一度ログインをお試しください
SwitchLang: 言語を変更する
TemplaesBundlesTitle: ドキュメント ライブラリ
TemplateAddHelperCancel: キャンセル
TemplateAddHelperSave: 保存
TemplateAddHelperSaveAndClose: 保存して閉じる
TemplateAddUserAddUser: ユーザーの追加
TemplateAddUserCancel: キャンセル
TemplateAddUserPasswordMessage: パスワードは、大文字、小文字、特殊文字、数字をそれぞれ 1 文字以上使用し、8 文字以上にしてください。
TemplateAdminArticleManagement: 記事の管理
TemplateAdminContentRoleGroups: コンテンツ ロール グループ
TemplateAdminCSHConfigFile: CSH 構成ファイルのダウンロードまたは更新
TemplateAdminElasticReindex: 検索インデックスの再構築
TemplateAdminExportComments: コメントのエクスポート
TemplateAdminExportRatings: 評価のエクスポート
TemplateAdminManageManuals: マニュアルの管理
TemplateAdminManageResourceManuals: リソース パッケージを管理する
TemplateAdminResourceIdCsv: ResourceId の Excel ファイルをダウンロードする
TemplateAdminSitemap: サイトマップを管理する
TemplateAdminSubjectSchemeLocalization: Subject Scheme ローカライズの管理
TemplateAdminTitle: 管理
TemplateAdminUploadCategoryXML: カテゴリ XML ファイルを管理する
TemplateAdminUploadCategoryXml: 新規のカテゴリ XML ファイルのアップロード
TemplateAdminUploadNewLangFile: 新規のデフォルト言語コード ファイルのアップロード
TemplateAdminUploadSubjectScheme: Subject Scheme の管理
TemplateAdminUserGroups: ユーザー グループ
TemplateAdminUserManagement: ユーザー管理
TemplateAdminUserRoles: ユーザーの役割
TemplateBundlePageCollapse: 折りたたむ
TemplateBundlePageCollapseTooltip: すべてのタイトルを折りたたむ
TemplateBundlePageComments: コメント
TemplateBundlePageContents: 目次
TemplateBundlePageExpand: 展開する
TemplateBundlePageExpandTooltip: 目次を展開する
TemplateBundlePageFeedback: フィードバック
TemplateBundlePageFeedbackThankYou: ありがとうございます。コメントを送信しました。
TemplateBundlePageFeedbackTooltip: フィードバックの送信
TemplateBundlePageFilterTitle: オプションを 1 つ以上選択してください
TemplateBundlePageNext: 次へ
TemplateBundlePageNextTopicTooltip: 次のトピックに移動する
TemplateBundlePageNo: いいえ
TemplateBundlePagePrevious: 前へ
TemplateBundlePagePrevTopicTooltip: 前のトピックに移動する
TemplateBundlePagePrint: 印刷
TemplateBundlePagePrintTooltip: トピックを印刷する
TemplateBundlePagePrivacy: プライバシーの保護のため、フィードバックには連絡先の情報を入力しないでください。弊社の
TemplateBundlePagePrivacyLast: プライバシー ポリシーを表示します。
TemplateBundlePageProvideFeedbackCharsLeft: 残り 500 文字
TemplateBundlePageProvideFeedbackTooltip: フィードバックの送信
TemplateBundlePageSaveAsPDF: PDF で保存する
TemplateBundlePageSavePDFTooltip: PDF で保存する
TemplateBundlePageSaveSelectedTopic: 選択したトピックの保存
TemplateBundlePageSaveSelectedTopicAndSubtopics: 選択したトピックとサブトピックの保存
TemplateBundlePageSeeAlso: 関連項目
TemplateBundlePageSend: 送信
TemplateBundlePageSendLink: 送信
TemplateBundlePageSendLinkTooltip: トピックへのリンクの送信
TemplateBundlePageSubmit: 送信
TemplateBundlePageWasThisInformationHelpful: この情報は役立ちましたか?
TemplateBundlePageYEs: はい
TemplateBundlesDeleteLanguage: 言語の削除
TemplateBundlesDeleteManual: マニュアルの削除
TemplateBundlesDownload: バンドルをダウンロードする
TemplateBundlesDownloadClassification: 分類 XML のダウンロード
TemplateBundlesHiddenBundle: 非表示のマニュアル
TemplateBundlesSearchManuals: マニュアルを検索する
TemplateBundlesUploadClassification: 分類 XML をアップロードする
TemplateClassificationForManual: マニュアルの場合
TemplateClassificationUploadClassificationMap: Classification Map XML のアップロード
TemplateClassificationWarnReindex: 注意: Classification Map をアップロードすると、サイト全体でインデックスが再作成されます。処理が完了するまで数分かかる場合があります。
TemplateContentRolesCRGroups: コンテンツ ロール グループ
TemplateContentRolesDefineNewCR: 新規コンテンツ ロールの定義
TemplateDefaultLayoutAdministration: 管理
TemplateDefaultLayoutArticles: 記事
TemplateDefaultLayoutBrowseDocumentation: 参照
TemplateDefaultLayoutDocumentation: ドキュメント ライブラリ
TemplateDefaultLayoutHome: ホーム
TemplateDefaultLayoutLanguages: United States - English
TemplateDefaultLayoutLinksCareers: 採用情報
TemplateDefaultLayoutLinksContactUs: お問い合わせ
TemplateDefaultLayoutLinksIntelCorp: © Intel Corporation
TemplateDefaultLayoutLinksLegalContractsandTerms: 適法契約と利用条件
TemplateDefaultLayoutLinksLegalNotices: 法的通知
TemplateDefaultLayoutLinksPrivacy: プライバシー
TemplateDefaultLayoutLinksSiteMap: サイトマップ
TemplateDefaultLayoutLinksWebsiteFeedback: サイトについてのお問い合わせ
TemplateDefaultLayoutLogout: サインアウト
TemplateDefaultLayoutProfile: プロファイル
TemplateDefaultLayoutVideos: 動画
TemplateFilterCurrentPublication: 現在の文書
TemplateRequestResetPasswordEmail: 電子メール
TemplateRequestResetPasswordSubmit: パスワード リセットの電子メールをリクエストする
TemplateSearchCurrentPublication name@Text: 現在の検索は文書「#{name}」に限定されています
TemplateSearchPageClearTooltip: フィルターをクリアする
TemplateSearchPageFirstPageTooltip: 先頭ページに移動する
TemplateSearchPageLastPageTooltip: 最終ページに移動する
TemplateSearchPageNextPageTooltip: 次のページに移動する
TemplateSearchPagePrevPageTooltip: 前のページに移動する
TemplateSearchPublicationTitle: 文書
TemplateSearchSortbyCreatedAsc: 作成日 - 昇順
TemplateSearchSortbyCreatedDec: 作成日 - 降順
TemplateSearchSortbyScore: スコア
TemplateSearchSortbyUpdatedAsc: 追加日 - 昇順
TemplateSearchSortbyUpdatedDec: 追加日 - 降順
TemplateSearchSortbyViews: 表示回数
TemplatesSearchPageClear: クリア
TemplatesSearchPageCurrentResultsFirst: 結果 
TemplatesSearchPageCurrentResults: /
TemplatesSearchPageRefilneResults: 結果の絞り込み
TemplatesSearchPageResultUpdated: 更新
TemplateUploadSitemapDisable: サイトマップを無効にする
TemplateUploadSitemapDisabled: サイトマップが無効になりました
TemplateUploadSitemapDisabledWord: 無効
TemplateUploadSitemapDownloadSitemap: sitemap.xml をダウンロードする
TemplateUploadSitemapEnable: サイトマップを有効にする
TemplateUploadSitemapEnabled: サイトマップが有効になりました
TemplateUploadSitemapEnabledWord: 有効
TemplateUploadSitemapLegend: sitemap.xml をアップロードする
TemplateUploadSitemapStatus sts@Text: サイトマップは #{sts} です
TextPass txt@Text: #{txt}
Upload: アップロード
UploadLink: 文書をアップロードする
YesodAuthStormPathSSOErrorOccured: エラーが発生しました
YesodAuthStormPathSSOLoginParamError: SSO ログイン パラメーターにエラーがありました
YesodAuthStormPathSSOLoginTryAgain: 次を使用してもう一度お試しください:
LoginSite: ログイン
LoginSiteEmail: メール アドレス
LoginSiteForgotPassword: パスワードを忘れた場合
LoginSiteMessage: 現在のログイン先:
LoginSiteZD: ZoominDocs ログイン
TemplateAdminCategoryfile: カテゴリ XML ファイル
TemplateAdminCshCurrent: 現在の CSH ルール
TemplateAdminCshDownload: 現在の CSH 構成ファイルをダウンロードする
TemplateAdminCshRuleContents: ルール コンテンツ
TemplateAdminCshRuleName: ルール名
TemplateAdminCshRulePriority: ルール優先度
TemplateAdminCshUpload: CSH 構成ファイルをアップロードする
TemplateAdminCurrentContentRoleGroups: 現在のコンテンツ ロール グループ
TemplateAdminDownloadDefaultLanguage: 現在のデフォルト言語ファイルをダウンロードする
TemplateAdminDownloadcurrentCategory: 現在のカテゴリ XML ファイルをダウンロードする
TemplateAdminListGroupCurrentGroups: 現在のグループ
TemplateAdminListGroupDefineNewGroup: 新規グループを定義する
TemplateAdminListRoleAdmin: 管理者
TemplateAdminListRoleCurrentRoles: 現在のロール
TemplateAdminListRoleDefineNewRole: 新規ロールを定義する
TemplateAdminListRoleRolesPublic : 公開
TemplateAdminListRoleViewer: ビューアー
TemplateAdminListUsersAction: アクション
TemplateAdminListUsersDeleteUser: ユーザーの削除
TemplateAdminListUsersEditPermissions: 権限を編集する
TemplateAdminListUsersEmail: 電子メール
TemplateAdminListUsersFullName: 氏名
TemplateAdminListUsersResetPassword: パスワードのリセット
TemplateAdminSubjectSchemeDeleteLanguage: 言語ファイルの削除
TemplateAdminSubjectSchemeDownload: ダウンロード
TemplateAdminSubjectSchemeDownloadLanguage: 言語ファイルをダウンロードする
TemplateAdminSubjectSchemeExistingLocalizations: 既存のローカライズ
TemplateAdminSubjectSchemeLanguage: 言語
TemplateAdminSubjectSchemeLocalizationTitle: Subject Scheme のローカライズ
TemplateAdminSubjectSchemeUpdate: 更新
TemplateAdminSubjectSchemeUpdateLanguage: 言語ファイルを更新する
TemplateAdminUploadCategoryfile: カテゴリ ファイルをアップロードする
TemplateAdminUploadDefaultLanguage: デフォルトの言語ファイルをアップロードする
TemplateAdminUploadSiteMapFile: サイトマップ ファイルをアップロードする
TemplateSubjectSchemeUpload: Subject Scheme をアップロードする
TemplateSubjectSchemeWarnReindex: 注意: 新しい Subject Scheme をアップロードすると、サイト全体でインデックスが再作成されます。処理が完了するまで数分かかる場合があります。
TemplatesSubjectSchemeChooseFile: ファイルを選択する (ask Vlatko, not in html)
TemplatesSubjectSchemeDownloadcurrent: 現在の Subject Scheme をダウンロードする
TemplatesSubjectSchemeNoFileChosen: ファイルが選択されていません