AdvancedSearch: Geavanceerd zoeken 
AdvancedSearchTooltip: Inhoudsfilters selecteren
BreadcrumbsProductDocumentationHome: Startpagina productdocumentatie
BreadcrumbsSearch: Zoeken
Cancel: Annuleren
Close: Sluiten
DeleteText: Verwijderen
ErrorOccured: Er is een fout opgetreden
FilterUsers: Gebruikers filteren:
FoundationLoginOnly: Aanmelden
FoundationLoginRegister: Aanmelden/registreren
HandlerAdminOnlyAdmin: Toegang geweigerd
HandlerBundlePageAltCSHResult: Alternatief CSH-onderwerp gevonden
HandlerCategoriesCategoryXMLFileUploaded: Categorie-XML-bestand geüpload
HandlerClassificationUpdated: Classificatieoverzicht bijgewerkt
HandlerClassificationXMLFile: Bijgewerkt classificatieoverzicht
HandlerCommentsComments: opmerkingen
HandlerCommentsOneComment: 1 opmerking
HandlerCommentsPostedCommentOn: heeft een opmerking gepubliceerd op:
HandlerContentRolesAreYouSureDelete: Weet u zeker dat u deze inhoudsrol wilt verwijderen?
HandlerContentRolesCRDeleted: Inhoudsrol verwijderd
HandlerContentRolesErrorDeleting: Er is een probleem opgetreden. De inhoudsrol is niet verwijderd.
HandlerCshAlternateCSHTopicFound: Alternatief CSH-onderwerp gevonden
HandlerCshCSHRulesUpdated: CSH-regels bijgewerkt
HandlerCshInvalidAliases: Ongeldige aliassleutels gevonden in CSH-URL
HandlerCshInvalidCSHRulesFile: Ongeldig CSH-regelbestand
HandlerCshNewCshFile: Nieuw CSH-configuratiebestand uploaden
HandlerCshReservedAliasesUsed: Gereserveerde aliassen gebruikt in CSH-configuratiebestand
HandlerCustomError400H2: 400
HandlerCustomError400H3: Onjuiste aanvraag
HandlerCustomError401H2: 401
HandlerCustomError401H3: Niet-toegestaan
HandlerCustomError403H2: 403
HandlerCustomError403H3: Verboden
HandlerCustomError404H2: 404
HandlerCustomError404H3: Niet gevonden
HandlerCustomError405H2: 405
HandlerCustomError405H3: Methode niet toegestaan
HandlerCustomError500H2: 500
HandlerCustomError500H3: Interne serverfout
HandlerFontoDocumentSaved: Document opgeslagen
HandlerFontoErrorGeneratingUUID: Fout bij genereren van UUID
HandlerFontoErrorParsingID: Fout bij parseren van id
HandlerFontoErrorParsingXML: Fout bij parseren van XML
HandlerFontoErrorParsingXMLToDocument: Fout bij parseren van XML naar document
HandlerFontoNoFileFound: Bestand niet gevonden
HandlerFontoNoIDFound: Id niet gevonden
HandlerFontoUntitledFromCursor: Naamloos - van cursor
HandlerGroupsErrorReadingGroupID: Fout bij lezen groeps-id
HandlerGroupsGroupUpdated: Groep bijgewerkt
HandlerGroupsMustUseUniqueGroupName: Moet unieke groepsnaam gebruiken
HandlerGroupsNoGroupNameFound: Geen groepsnaam gevonden
HandlerGroupsUnableAssignRole: Kan geen rol toewijzen
HandlerHowtoContent: Inhoud
HandlerHowtoDeleted: Artikel verwijderd
HandlerHowtoInsufficientPermissions: Onvoldoende machtigingen om dit artikel te bewerken
HandlerHowtoSaved: Opgeslagen
HandlerHowtoTitle: Titel
HandlerHtmlEmptyMyDocs: Lege MijnDocs
HandlerLangDefaultLanguageCodeFileUpdated: Bijgewerkt standaard taalcodebestand
HandlerLangNewLangFile: Nieuw standaard taalcodebestand uploaden
HandlerMyPubSourcePublication: Bronpublicatie
HandlerProfileDisplayName: Weergavenaam
HandlerProfileScreenName: Schermnaam
HandlerProfileUpdated: Profiel bijgewerkt
HandlerProfileUsernameInUse: Gebruikersnaam bestaat al
HandlerRatingsInvalidRating: Ongeldige classificatie
HandlerRatingsRatingRecorded: Uw classificatie is geregistreerd
HandlerRatingsRatingUpdated: Uw classificatie is bijgewerkt
HandlerRolesErrorReadingRoleID: Fout bij lezen rol-id
HandlerRolesMustUseUniqueRoleName: Gebruik een unieke rolnaam
HandlerRolesNoRoleNameFound: Geen rolnaam gevonden
HandlerRolesNotEnoughAdminUsersRemaining: Kan geen gebruikers toewijzen
HandlerRolesSelectedPermissionsLessThenDefault: Kan geen machtigingen toewijzen: geselecteerde machtigingen zijn minder dan standaard machtigingenset
HandlerSearchAllResults: Alle resultaten
HandlerSearchNoResults: Geen resultaten
HandlerSearchOneResult: Eén resultaat
HandlerSitemapFile: Siteoverzichtsbestand
HandlerSitemapFileUploaded: Siteoverzicht is bijgewerkt.
HandlerSubjectSchemeInvalidSubjectSchemeLocalizationFile: Ongeldig lokalisatiebestand van onderwerpschema
HandlerSubjectSchemeLangDeleted lang@Text: #{lang} Verwijderd lokalisatiebestand
HandlerSubjectSchemeLangsAvailable: Beschikbare talen
HandlerSubjectSchemeLangsDeleteConfirm: Wilt u het lokalisatiebestand echt verwijderen? 
HandlerSubjectSchemeLangsDeleteError: Fout bij verwijderen lokalisatiebestand.
HandlerSubjectSchemeLangsNewFile: Lokalisatiebestand van nieuw onderwerpschema uploaden
HandlerSubjectSchemeLangUpdated lang@Text: #{lang} Bijgewerkt lokalisatiebestand
HandlerSubjectSchemeLangUploaded lang@Text: #{lang} Geüpload lokalisatiebestand 
HandlerSubjectSchemeProblemOccurredWhileUploadingSubjectScheme: Er is een probleem opgetreden bij het uploaden van het onderwerpschema.
HandlerSubjectSchemeSubjectSchemeUploadedSuccessfully: Onderwerpschema is geüpload
HandlerSubjectSchemeUnknownLanguageCode: Onbekende taalcode
HandlerSubjectSchemeUpdated: Onderwerpschema bijgewerkt
HandlerSubjectSchemeXMLFile: XML-bestand onderwerpschema
HandlerUploadBundleBundle: bundel
HandlerUploadBundleDeleteError x@Text: Fout bij verwijderen van #{x}
HandlerUploadBundleDeleteSuccess x@Text: #{x} is verwijderd
HandlerUploadBundleError: Fout
HandlerUploadBundleErrorPleaseUpdateSuiteBundleVersion: Fout: werk uw bundelversie bij
HandlerUploadBundleNoContentToDelete x@Text: Geen te verwijderen inhoud in #{x} 
HandlerUploadBundleOneBundleError: Fout bij vullen geüploade bundel
HandlerUploadBundlePublicationUploadedSuccessfully: Publicatie is geüpload
HandlerUploadBundleSheaf: sheaf
HandlerUsersAddedSuccess: Gebruiker is toegevoegd
HandlerUsersBadEmail: Dat e-mailadres is niet geregistreerd
HandlerUsersCRCreated: Inhoudsrolgroep gemaakt
HandlerUsersCRGroupNameInUse: Inhoudsrolnaam is al in gebruik
HandlerUsersCRSetGroupName: Geef een naam op voor deze inhoudsrolgroep
HandlerUsersCRUpdated: Inhoudsrolgroep bijgewerkt
HandlerUsersDefineCR: Nieuwe inhoudsrolgroep definiëren
HandlerUsersDeleteSuccess: Gebruiker is verwijderd
HandlerUsersEmailError: Fout bij verzenden van e-mail voor opnieuw instellen van wachtwoord
HandlerUsersInvalidToken: Ongeldige token
HandlerUsersNoResetToken: Geen opnieuw ingestelde token
HandlerUsersNoRoleIdFound: Geen rol-id gevonden
HandlerUsersPasswordEmailSent: E-mail voor opnieuw instellen wachtwoord is verzonden
HandlerUsersRegisterSuccess: Gebruiker is geregistreerd
HandlerUsersResetPasswordError: Fout bij opnieuw instellen van wachtwoord
HandlerUsersRolesUpdated: Gebruikersrollen bijgewerkt
HandlerUsersUnableToAssignUserPermissionRole: Kan geen gebruikersmachtigingsrol toewijzen
HandlerUsersUnknownError: Onbekende fout
HideTOC: Inhoudsopgave verbergen
ImportAddHelperProblemRunningAddHelper: Probleem bij uitvoeren van addHelper
ImportBundlesTooManyTopics num@Int: Maximaal #{show num} onderwerpen kunnen worden gepubliceerd. Selecteer minder onderwerpen en probeer het opnieuw.
ImportElasticAnalyzerError: - Opmerking: fout van aangepast analyseprogramma, zie logboek voor details. Standaard analyseprogramma wordt gebruikt. 
ImportElasticErrorRebuilding: Fout bij opnieuw opbouwen van index, zie logboek voor meer details.
ImportElasticErrorUpdating: Fout bij bijwerken van index, zie logboek voor meer details.
ImportElasticIndexRebuilt x@Text: Index is opnieuw opgebouwd #{x}
ImportElasticIndexUpdated x@Text: Index is bijgewerkt #{x}
ImportElasticNoPagesFound: Geen pagina's gevonden in database - index opnieuw ingesteld.
ImportElasticNoPagesInBundle: Geen pagina's gevonden in upload
ImportInvalidPassword: Ongeldig wachtwoord
ImportRatingsOneRating: 1 classificatie
ImportRatingsRatings: Classificaties
ImportRolesPermissionDenied: Machtiging geweigerd
ImportSearchNoCategoriesUploaded: Geen categorieën-XML-bestand geüpload
ImportSearchUnknownTopicLink: *** onbekende onderwerpkoppeling ***
ImportUsersCaptchaError: Ongeldige reCAPTCHA 
ImportUsersCaptchaParseError: reCAPTCHA-fout
ImportUsersEmailFieldError: Geen e-mailveld gevonden.
ImportUsersFldEmail: E-mail
ImportUsersFldFirstName: Voornaam
ImportUsersFldLastName: Achternaam
ImportUsersFldPassword: Wachtwoord
ImportUsersFldReenterPass: Wachtwoord opnieuw invoeren
ImportUsersInvalidPass: Ongeldig wachtwoord: wachtwoord moet ten minste 8 tekens bevatten, waaronder ten minste 1 hoofdletter, 1 kleine letter, 1 speciaal teken en 1 cijfer.
LoggedInAs email@Text: Aangemeld als #{email}.
Manuals: Handleidingen
PDFPage: Pagina
ProductDocumentationSplashTitle: Productdocumentatie 
PublishHowto: Publiceren
ResultsPerPage: Resultaten per pagina
ResultsPerPageShow: xx per pagina tonen
Search: Zoeken in productdocumentatie
SearchContent: Zoek in deze inhoud
SearchHome: Zoeken in productdocumentatie
ShowTOC: Inhoudsopgave weergeven
SSOLoginParamError: Er is een fout opgetreden bij de SSO-aanmeldingsparameters
SSOLoginTryAgain: Probeer u opnieuw aan te melden met
SwitchLang: Taal wijzigen
TemplaesBundlesTitle: Documentatiebibliotheek
TemplateAddHelperCancel: Annuleren
TemplateAddHelperSave: Opslaan
TemplateAddHelperSaveAndClose: Opslaan en sluiten
TemplateAddUserAddUser: Gebruiker toevoegen
TemplateAddUserCancel: Annuleren
TemplateAddUserPasswordMessage: Wachtwoord moet ten minste 8 tekens bevatten, waaronder ten minste 1 hoofdletter, 1 kleine letter, 1 speciaal teken en 1 cijfer.
TemplateAdminArticleManagement: Artikelbeheer
TemplateAdminContentRoleGroups: Inhoudsrolgroepen
TemplateAdminCSHConfigFile: CSH-configuratiebestand downloaden of bijwerken
TemplateAdminElasticReindex: Zoekindex opnieuw opbouwen
TemplateAdminExportComments: Opmerkingen exporteren
TemplateAdminExportRatings: Classificaties exporteren
TemplateAdminManageManuals: Handleidingen beheren
TemplateAdminManageResourceManuals: Bronpakketten beheren
TemplateAdminResourceIdCsv: Excel-bestand met bron-id's downloaden
TemplateAdminSitemap: Siteoverzicht beheren
TemplateAdminSubjectSchemeLocalization: Onderwerpschemalokalisatie beheren
TemplateAdminTitle: Beheer
TemplateAdminUploadCategoryXML: Categorie-XML-bestand beheren
TemplateAdminUploadCategoryXml: Een nieuw categorie-XML-bestand uploaden
TemplateAdminUploadNewLangFile: Een nieuw standaard taalcodebestand uploaden
TemplateAdminUploadSubjectScheme: Onderwerpschema beheren
TemplateAdminUserGroups: Gebruikersgroepen
TemplateAdminUserManagement: Gebruikersbeheer
TemplateAdminUserRoles: Gebruikersrollen
TemplateBundlePageCollapse: Samenvouwen
TemplateBundlePageCollapseTooltip: Alle titels samenvouwen
TemplateBundlePageComments: Opmerkingen
TemplateBundlePageContents: Inhoud
TemplateBundlePageExpand: Uitvouwen
TemplateBundlePageExpandTooltip: Inhoudsopgave uitvouwen
TemplateBundlePageFeedback: Feedback
TemplateBundlePageFeedbackThankYou: Dank u! Uw opmerkingen zijn verzonden. 
TemplateBundlePageFeedbackTooltip: Feedback indienen
TemplateBundlePageFilterTitle: Selecteer een of meer opties
TemplateBundlePageNext: Volgende
TemplateBundlePageNextTopicTooltip: Ga naar volgend onderwerp
TemplateBundlePageNo: Nee
TemplateBundlePagePrevious: Vorige 
TemplateBundlePagePrevTopicTooltip: Ga naar vorig onderwerp
TemplateBundlePagePrint: Afdrukken
TemplateBundlePagePrintTooltip: Onderwerp afdrukken
TemplateBundlePagePrivacy: Neem ter bescherming van uw privacy geen contactgegevens op in uw feedback. Lees ons privacybeleid.
TemplateBundlePageProvideFeedbackTooltip: Feedback geven
TemplateBundlePageSaveAsPDF: Opslaan als PDF
TemplateBundlePageSavePDFTooltip: Opslaan als PDF
TemplateBundlePageSaveSelectedTopic: Geselecteerd onderwerp opslaan
TemplateBundlePageSaveSelectedTopicAndSubtopics: Geselecteerd onderwerp en subonderwerpen opslaan
TemplateBundlePageSeeAlso: Zie ook
TemplateBundlePageSend: Verzenden
TemplateBundlePageSendLink: Verzenden
TemplateBundlePageSendLinkTooltip: Koppeling naar onderwerp verzenden
TemplateBundlePageSubmit: Indienen
TemplateBundlePageWasThisInformationHelpful: Was deze informatie nuttig?
TemplateBundlePageYEs: Ja
TemplateBundlesDeleteLanguage: Taal verwijderen
TemplateBundlesDeleteManual: Handleiding verwijderen
TemplateBundlesDownload: Bundel downloaden
TemplateBundlesDownloadClassification: Classificatie-XML downloaden
TemplateBundlesHiddenBundle: Verborgen handleiding
TemplateBundlesSearchManuals: Zoeken in handleidingen
TemplateBundlesUploadClassification: Classificatie-XML uploaden
TemplateClassificationForManual: Voor handleiding
TemplateClassificationUploadClassificationMap: Classificatieoverzicht-XML uploaden
TemplateClassificationWarnReindex: OPMERKING: als een classificatieoverzicht wordt geüpload, wordt de gehele site opnieuw geïndexeerd. Dit kan enkele minuten duren.
TemplateContentRolesCRGroups: Inhoudsrolgroepen
TemplateContentRolesDefineNewCR: Nieuwe inhoudsrol definiëren
TemplateDefaultLayoutAdministration: Beheer
TemplateDefaultLayoutArticles: Artikelen
TemplateDefaultLayoutBrowseDocumentation: Bladeren
TemplateDefaultLayoutDocumentation: Documentatiebibliotheek
TemplateDefaultLayoutHome: Startpagina
TemplateDefaultLayoutLanguages: United States - English
TemplateDefaultLayoutLinksCareers: Carrières
TemplateDefaultLayoutLinksContactUs: Contact
TemplateDefaultLayoutLinksIntelCorp: © Intel Corporation
TemplateDefaultLayoutLinksLegalContractsandTerms: Juridische contracten en voorwaarden
TemplateDefaultLayoutLinksLegalNotices: Juridische kennisgevingen  
TemplateDefaultLayoutLinksSiteMap: Websiteoverzicht
TemplateDefaultLayoutLinksWebsiteFeedback: Websitefeedback
TemplateDefaultLayoutLogout: Afmelden
TemplateDefaultLayoutProfile: Profiel
TemplateDefaultLayoutVideos: Video’s
TemplateFilterCurrentPublication: Huidige publicatie
TemplateRequestResetPasswordEmail: E-mail
TemplateRequestResetPasswordSubmit: E-mail voor aanvragen van opnieuw instellen wachtwoord
TemplateSearchCurrentPublication name@Text: Huidige zoekopdracht is beperkt tot de publicatie '#{name}'
TemplateSearchPageClearTooltip: Filters wissen
TemplateSearchPageFirstPageTooltip: Ga naar eerste pagina
TemplateSearchPageLastPageTooltip: Ga naar laatste pagina
TemplateSearchPageNextPageTooltip: Ga naar volgende pagina
TemplateSearchPagePrevPageTooltip: Ga naar de vorige pagina
TemplateSearchPublicationTitle: Publicatie
TemplateSearchSortbyCreatedAsc: Datum gemaakt - oplopend
TemplateSearchSortbyCreatedDec: Datum gemaakt - aflopend
TemplateSearchSortbyScore: Score
TemplateSearchSortbyUpdatedAsc: Datum toegevoegd - oplopend
TemplateSearchSortbyUpdatedDec: Datum toegevoegd - aflopend
TemplateSearchSortbyViews: Aantal weergaven
TemplatesSearchPageClear: Wissen
TemplatesSearchPageCurrentResults: Resultaten xx-yy van zzz
TemplatesSearchPageRefilneResults: Resultaten verfijnen
TemplatesSearchPageResultUpdated: Bijgewerkt
TemplateUploadSitemapDisable: Siteoverzicht uitschakelen
TemplateUploadSitemapDisabled: Siteoverzicht uitgeschakeld
TemplateUploadSitemapDisabledWord: Uitgeschakeld
TemplateUploadSitemapDownloadSitemap: sitemap.xml downloaden
TemplateUploadSitemapEnable: Siteoverzicht inschakelen
TemplateUploadSitemapEnabled: Siteoverzicht ingeschakeld
TemplateUploadSitemapEnabledWord: Ingeschakeld
TemplateUploadSitemapLegend: sitemap.xml uploaden
TemplateUploadSitemapStatus sts@Text: Siteoverzicht is #{sts}
TemplTemplateBundlePageProvideFeedbackTooltip: Feedback indienen
TextPass txt@Text: #{txt}
Upload: Uploaden
UploadLink: Publicatie uploaden
YesodAuthStormPathSSOErrorOccured: Er is een fout opgetreden
YesodAuthStormPathSSOLoginParamError: Er is een fout opgetreden bij de SSO-aanmeldingsparameters
YesodAuthStormPathSSOLoginTryAgain: Probeer u opnieuw aan te melden met