AdvancedSearch: Avansert søk 
AdvancedSearchTooltip: Velg innholdsfiltre
BreadcrumbsProductDocumentationHome: Hjemmeside for produktdokumentasjon
BreadcrumbsSearch: Søk
Cancel: Avbryt
Close: Lukk
DeleteText: Slett
ErrorOccured: Det oppstod en feil
FilterUsers: Filterbrukere:
FoundationLoginOnly: Logg på
FoundationLoginRegister: Logg på / registrer
HandlerAdminOnlyAdmin: Ingen tilgang
HandlerBundlePageAltCSHResult: Alternativt CSH-emne funnet
HandlerCategoriesCategoryXMLFileUploaded: XML-fil for kategori er lastet opp
HandlerClassificationUpdated: Klassifiseringskart oppdatert
HandlerClassificationXMLFile: Oppdatert klassifiseringskart
HandlerCommentsComments: kommentarer
HandlerCommentsOneComment: 1 kommentar
HandlerCommentsPostedCommentOn: publiserte en kommentar til:
HandlerContentRolesAreYouSureDelete: Er du sikker på at du vil slette denne innholdsrollen?
HandlerContentRolesCRDeleted: Innholdsrolle slettet
HandlerContentRolesErrorDeleting: Det oppstod et problem. Innholdsrollen ble ikke slettet.
HandlerCshAlternateCSHTopicFound: Alternativt CSH-emne funnet
HandlerCshCSHRulesUpdated: CSH-regler oppdatert
HandlerCshInvalidAliases: Ugyldige alias-nøkler funnet i CSH-URL
HandlerCshInvalidCSHRulesFile: Ugyldig CSH-regelfil
HandlerCshNewCshFile: Last opp ny CSH-konfigurasjonsfil
HandlerCshReservedAliasesUsed: Reserverte aliaser ble brukt i CSH-konfigurasjonsfil
HandlerCustomError400H2: 400
HandlerCustomError400H3: Feil ved forespørsel
HandlerCustomError401H2: 401
HandlerCustomError401H3: Ikke autorisert
HandlerCustomError403H2: 403
HandlerCustomError403H3: Forbudt
HandlerCustomError404H2: 404
HandlerCustomError404H3: Ikke funnet
HandlerCustomError405H2: 405
HandlerCustomError405H3: Metoden er ikke tillatt
HandlerCustomError500H2: 500
HandlerCustomError500H3: Intern serverfeil
HandlerFontoDocumentSaved: Dokument er lagret
HandlerFontoErrorGeneratingUUID: Feil ved generering av UUID
HandlerFontoErrorParsingID: Feil ved analysering av ID
HandlerFontoErrorParsingXML: Feil ved analysering av XML
HandlerFontoErrorParsingXMLToDocument: Feil ved analysering av XML til dokument
HandlerFontoNoFileFound: Finner ikke filen
HandlerFontoNoIDFound: Finner ikke ID
HandlerFontoUntitledFromCursor: Uten navn – fra markør
HandlerGroupsErrorReadingGroupID: Feil ved lesing av gruppe-ID
HandlerGroupsGroupUpdated: Gruppe oppdatert
HandlerGroupsMustUseUniqueGroupName: Unikt gruppenavn må brukes
HandlerGroupsNoGroupNameFound: Finner ikke gruppenavn
HandlerGroupsUnableAssignRole: Kan ikke tildele rolle
HandlerHowtoContent: Innhold
HandlerHowtoDeleted: Artikkel slettet
HandlerHowtoInsufficientPermissions: Manglende tillatelser til å redigere denne artikkelen
HandlerHowtoSaved: Lagret
HandlerHowtoTitle: Tittel
HandlerHtmlEmptyMyDocs: Tøm MyDocs
HandlerLangDefaultLanguageCodeFileUpdated: Oppdatert standard språkkodefil
HandlerLangNewLangFile: Last opp ny standard språkkodefil
HandlerMyPubSourcePublication: Kildepublikasjon
HandlerProfileDisplayName: Visningsnavn
HandlerProfileScreenName: Skjermnavn
HandlerProfileUpdated: Profil oppdatert
HandlerProfileUsernameInUse: Brukernavnet finnes
HandlerRatingsInvalidRating: Ugyldig vurdering
HandlerRatingsRatingRecorded: Vurderingen er registrert
HandlerRatingsRatingUpdated: Vurderingen er oppdatert
HandlerRolesErrorReadingRoleID: Feil ved lesing av rolle-ID
HandlerRolesMustUseUniqueRoleName: Bruk et unikt rollenavn
HandlerRolesNoRoleNameFound: Finner ikke rollenavn
HandlerRolesNotEnoughAdminUsersRemaining: Kan ikke tildele brukere
HandlerRolesSelectedPermissionsLessThenDefault: Kan ikke tildele tillatelser: Valgte tillatelser er færre enn standard tillatelsessett
HandlerSearchAllResults: Alle resultater
HandlerSearchNoResultsMsgTryFollowing: Ingen resultater. Prøv følgende:
HandlerSearchNoResultsMsgSpelledCorrectly: Kontroller at alle ordene er stavet riktig.
HandlerSearchNoResultsMsgTryDifferent: Prøv andre søkeord.
HandlerSearchNoResultsMsgMoreGeneral: Prøv mer generelle søkeord.
HandlerSearchNoResultsMsgNoFindProdVer: Du må ikke finne produktet eller versjonen? Gå til Intel Security ServicePortal.
HandlerSearchNoResults: Ingen resultater
HandlerSearchOneResult: Ett resultat
HandlerSitemapFile: Områdekartfil
HandlerSitemapFileUploaded: Områdekart er oppdatert.
HandlerSubjectSchemeInvalidSubjectSchemeLocalizationFile: Ugyldig plasseringsfil for emneskjema
HandlerSubjectSchemeLangDeleted lang@Text: #{lang} slettet plasseringsfil
HandlerSubjectSchemeLangsAvailable: Tilgjengelige språk
HandlerSubjectSchemeLangsDeleteConfirm: Er du sikker på at du vil slette plasseringsfilen? 
HandlerSubjectSchemeLangsDeleteError: Feil ved sletting av lokaliseringsfil.
HandlerSubjectSchemeLangsNewFile: Last opp ny emneskjema-lokaliseringsfil
HandlerSubjectSchemeLangUpdated lang@Text: #{lang} oppdaterte plasseringsfil
HandlerSubjectSchemeLangUploaded lang@Text: #{lang} lastet opp plasseringsfil 
HandlerSubjectSchemeProblemOccurredWhileUploadingSubjectScheme: Det oppstod et problem ved opplasting av emneskjemaet.
HandlerSubjectSchemeSubjectSchemeUploadedSuccessfully: Emneskjemaet er lastet opp
HandlerSubjectSchemeUnknownLanguageCode: Ukjent språkkode
HandlerSubjectSchemeUpdated: Emneskjema oppdatert
HandlerSubjectSchemeXMLFile: Emneskjema XML-fil
HandlerUploadBundleBundle: pakke
HandlerUploadBundleDeleteError x@Text: Feil ved sletting av #{x}
HandlerUploadBundleDeleteSuccess x@Text: #{x} er slettet
HandlerUploadBundleError: Feil
HandlerUploadBundleErrorPleaseUpdateSuiteBundleVersion: Feil. Oppdater pakkeversjonen
HandlerUploadBundleNoContentToDelete x@Text: Det er ikke noe innhold å slette i #{x} 
HandlerUploadBundleOneBundleError: Feil ved utfylling av opplastet pakke
HandlerUploadBundlePublicationUploadedSuccessfully: Publikasjon er lastet opp
HandlerUploadBundleSheaf: sheaf
HandlerUsersAddedSuccess: Brukeren er lagt til
HandlerUsersBadEmail: Den e-postadressen er ikke registrert
HandlerUsersCRCreated: Innholdsrollegruppe opprettet
HandlerUsersCRGroupNameInUse: Innholdsrollenavnet er allerede i bruk
HandlerUsersCRSetGroupName: Angi et navn for denne innholdsrollegruppen
HandlerUsersCRUpdated: Innholdsrollegruppe oppdatert
HandlerUsersDefineCR: Definer ny innholdsrollegruppe
HandlerUsersDeleteSuccess: Bruker er slettet
HandlerUsersEmailError: Feil ved sending av e-post om tilbakestilling av passord
HandlerUsersInvalidToken: Ugyldig symbol
HandlerUsersNoResetToken: Ingen tilbakestilte symboler
HandlerUsersNoRoleIdFound: Finner ikke rolle-ID
HandlerUsersPasswordEmailSent: E-post for tilbakestilling av passord er sendt
HandlerUsersRegisterSuccess: Bruker er registrert
HandlerUsersResetPasswordError: Feil ved tilbakestilling av passord
HandlerUsersRolesUpdated: Brukerroller oppdatert
HandlerUsersUnableToAssignUserPermissionRole: Kan ikke tildele brukertillatelsesrolle
HandlerUsersUnknownError: Ukjent feil
HideTOC: Skjul innholdsfortegnelse
ImportAddHelperProblemRunningAddHelper: Problem ved kjøring av addHelper
ImportBundlesTooManyTopics num@Int: Maks #{show num} emner kan publiseres. Velg færre emner og prøv på nytt.
ImportElasticAnalyzerError: - Merk: Feil ved tilpasset analyse. Loggen inneholder detaljer. Med standard analyse. 
ImportElasticErrorRebuilding: Feil ved bygging av indeks på nytt. Loggen inneholder mer informasjon.
ImportElasticErrorUpdating: Feil ved oppdatering av indeks. Loggen inneholder mer informasjon.
ImportElasticIndexRebuilt x@Text: Indeks er bygd på nytt #{x}
ImportElasticIndexUpdated x@Text: Indeks er oppdatert #{x}
ImportElasticNoPagesFound: Fant ingen sider i databasen. Indeks er tilbakestilt.
ImportElasticNoPagesInBundle: Finner ingen sider i opplastet innhold
ImportInvalidPassword: Ugyldig passord
ImportRatingsOneRating: 1 Vurdering
ImportRatingsRatings: Vurderinger
ImportRolesPermissionDenied: Tillatelse avslått
ImportSearchNoCategoriesUploaded: Ingen XML-fil for kategori er lastet opp
ImportSearchUnknownTopicLink: *** ukjent emnekobling ***
ImportUsersCaptchaError: Ugyldig reCAPTCHA 
ImportUsersCaptchaParseError: reCAPTCHA-feil
ImportUsersEmailFieldError: Fant ikke e-postfelt.
ImportUsersFldEmail: E-post
ImportUsersFldFirstName: Fornavn
ImportUsersFldLastName: Etternavn
ImportUsersFldPassword: Passord
ImportUsersFldReenterPass: Oppgi passord på nytt
ImportUsersInvalidPass: Ugyldig passord: Valgt passord må være på minst åtte tegn, inkludert minst én stor bokstav, én liten bokstav, ett spesialtegn og ett tall.
LoggedInAs email@Text: Logget inn som #{email}.
Manuals: Håndbøker
PDFPage: Side
ProductDocumentationSplashTitle: Produktdokumentasjon 
PublishHowto: Publiser
ResultsPerPage: Resultater per side
ResultsPerPageShowFirst: Vis
ResultsPerPageShow: per side
Search: Søk i produktdokumentasjonen
SearchContent: Søk i dette innholdet
SearchHome: Søk i produktdokumentasjonen
ShowTOC: Vis innholdsfortegnelse
SSOLoginParamError: Det var en feil med parameterne for enkeltpålogging
SSOLoginTryAgain: Prøv å logge på med
SwitchLang: Endre språk
TemplaesBundlesTitle: Dokumentasjonsbibliotek
TemplateAddHelperCancel: Avbryt
TemplateAddHelperSave: Lagre
TemplateAddHelperSaveAndClose: Lagre og lukk
TemplateAddUserAddUser: Legg til bruker
TemplateAddUserCancel: Avbryt
TemplateAddUserPasswordMessage: Passord må være på minst åtte tegn, inkludert minst én stor bokstav, én liten bokstav, ett spesialtegn og ett tall.
TemplateAdminArticleManagement: Artikkeladministrasjon
TemplateAdminContentRoleGroups: Innholdsrollegrupper
TemplateAdminCSHConfigFile: Last ned eller oppdater CSH-konfigurasjonsfil
TemplateAdminElasticReindex: Gjenoppbygg søkeindeks
TemplateAdminExportComments: Eksporter kommentarer
TemplateAdminExportRatings: Eksporter vurderinger
TemplateAdminManageManuals: Administrer håndbøker
TemplateAdminManageResourceManuals: Administrer ressurspakker
TemplateAdminResourceIdCsv: Last ned Excel-fil med ResourceIds
TemplateAdminSitemap: Administrer områdekart
TemplateAdminSubjectSchemeLocalization: Administrer lokalisering av emneskjema
TemplateAdminTitle: Administrasjon
TemplateAdminUploadCategoryXML: Administrer XML-fil med kategori
TemplateAdminUploadCategoryXml: Last opp en ny XML-fil med kategori
TemplateAdminUploadNewLangFile: Last opp en ny standard språkkodefil
TemplateAdminUploadSubjectScheme: Administrer emneskjema
TemplateAdminUserGroups: Brukergrupper
TemplateAdminUserManagement: Brukeradministrasjon
TemplateAdminUserRoles: Brukerroller
TemplateBundlePageCollapse: Minimer
TemplateBundlePageCollapseTooltip: Minimer alle titler
TemplateBundlePageComments: Kommentarer
TemplateBundlePageContents: Innhold
TemplateBundlePageExpand: Utvid
TemplateBundlePageExpandTooltip: Utvid innholdsfortegnelse
TemplateBundlePageFeedback: Tilbakemeldinger
TemplateBundlePageFeedbackThankYou: Mange takk. Kommentarene er sendt. 
TemplateBundlePageFeedbackTooltip: Sende inn tilbakemeldinger
TemplateBundlePageFilterTitle: Velg ett eller flere alternativer
TemplateBundlePageNext: Neste
TemplateBundlePageNextTopicTooltip: Gå til neste emne
TemplateBundlePageNo: Nei
TemplateBundlePagePrevious: Forrige 
TemplateBundlePagePrevTopicTooltip: Gå til forrige emne
TemplateBundlePagePrint: Skriv ut
TemplateBundlePagePrintTooltip: Skriv ut emne
TemplateBundlePagePrivacy: Unngå å ta med kontaktinformasjon i tilbakemeldingen, slik at personvernet ditt opprettholdes. Se retningslinjene våre
TemplateBundlePagePrivacyLast: for personvern.
TemplateBundlePageProvideFeedbackCharsLeft: 500 tekens over
TemplateBundlePageProvideFeedbackTooltip: Gi tilbakemeldinger
TemplateBundlePageSaveAsPDF: Lagre som PDF
TemplateBundlePageSavePDFTooltip: Lagre som PDF
TemplateBundlePageSaveSelectedTopic: Lagre det valgte emnet
TemplateBundlePageSaveSelectedTopicAndSubtopics: Lagre det valgte emnet og underemner
TemplateBundlePageSeeAlso: Se også
TemplateBundlePageSend: Sende
TemplateBundlePageSendLink: Send
TemplateBundlePageSendLinkTooltip: Send kobling til emne
TemplateBundlePageSubmit: Send inn
TemplateBundlePageWasThisInformationHelpful: Var denne informasjonen til hjelp for deg?
TemplateBundlePageYEs: Ja
TemplateBundlesDeleteLanguage: Slett språk
TemplateBundlesDeleteManual: Slett håndbok
TemplateBundlesDownload: Last ned pakke
TemplateBundlesDownloadClassification: Last ned klassifiserings-XML
TemplateBundlesHiddenBundle: Skjult håndbok
TemplateBundlesSearchManuals: Søk i håndbøker
TemplateBundlesUploadClassification: Last opp klassifiserings-XML
TemplateClassificationForManual: For håndbok
TemplateClassificationUploadClassificationMap: Last opp klassifiseringskart-XML
TemplateClassificationWarnReindex: MERK: Opplasting av et klassifiseringskart fører til at hele området indekseres på nytt. Dette kan ta flere minutter.
TemplateContentRolesCRGroups: Innholdsrollegrupper
TemplateContentRolesDefineNewCR: Definer ny innholdsrolle
TemplateDefaultLayoutAdministration: Administrasjon
TemplateDefaultLayoutArticles: Artikler
TemplateDefaultLayoutBrowseDocumentation: Bla gjennom
TemplateDefaultLayoutDocumentation: Dokumentasjonsbibliotek
TemplateDefaultLayoutHome: Hjem
TemplateDefaultLayoutLanguages: United States - English
TemplateDefaultLayoutLinksCareers: Jobbmuligheter
TemplateDefaultLayoutLinksContactUs: Kontakt oss
TemplateDefaultLayoutLinksIntelCorp: © Intel Corporation
TemplateDefaultLayoutLinksLegalContractsandTerms: Juridiske kontrakter og vilkår
TemplateDefaultLayoutLinksLegalNotices: Juridiske merknader 
TemplateDefaultLayoutLinksPrivacy: Privatliv
TemplateDefaultLayoutLinksSiteMap: Områdekart
TemplateDefaultLayoutLinksWebsiteFeedback: Tilbakemelding om nettsted
TemplateDefaultLayoutLogout: Logg av
TemplateDefaultLayoutProfile: Profil
TemplateDefaultLayoutVideos: Videoer
TemplateFilterCurrentPublication: Gjeldende publikasjon
TemplateRequestResetPasswordEmail: E-post
TemplateRequestResetPasswordSubmit: E-post med forespørsel om tilbakestilling av passord
TemplateSearchCurrentPublication name@Text: Gjeldende søk er begrenset til publikasjonen #{name}
TemplateSearchPageClearTooltip: Tøm filtre
TemplateSearchPageFirstPageTooltip: Gå til første side
TemplateSearchPageLastPageTooltip: Gå til siste side
TemplateSearchPageNextPageTooltip: Gå til neste side
TemplateSearchPagePrevPageTooltip: Gå til forrige side
TemplateSearchPublicationTitle: Publikasjon
TemplateSearchSortbyCreatedAsc: Dato opprettet – stigende
TemplateSearchSortbyCreatedDec: Dato opprettet – synkende
TemplateSearchSortbyScore: Poeng
TemplateSearchSortbyUpdatedAsc: Dato lagt til – stigende
TemplateSearchSortbyUpdatedDec: Dato lagt til – synkende
TemplateSearchSortbyViews: Antall visninger
TemplatesSearchPageClear: Fjern
TemplatesSearchPageCurrentResultsFirst: Resultater
TemplatesSearchPageCurrentResults: av
TemplatesSearchPageRefilneResults: Avgrense søkeresultatene
TemplatesSearchPageResultUpdated: Oppdatert
TemplateUploadSitemapDisable: Deaktiver områdekart
TemplateUploadSitemapDisabled: Områdekart deaktivert
TemplateUploadSitemapDisabledWord: Deaktivert
TemplateUploadSitemapDownloadSitemap: Last ned sitemap.xml
TemplateUploadSitemapEnable: Aktiver områdekart
TemplateUploadSitemapEnabled: Områdekart aktivert
TemplateUploadSitemapEnabledWord: Aktivert
TemplateUploadSitemapLegend: Last opp sitemap.xml
TemplateUploadSitemapStatus sts@Text: Områdekart er #{sts}
TextPass txt@Text: #{txt}
Upload: Last opp
UploadLink: Last opp publikasjon
YesodAuthStormPathSSOErrorOccured: Det oppstod en feil
YesodAuthStormPathSSOLoginParamError: Det var en feil med parameterne for enkeltpålogging
YesodAuthStormPathSSOLoginTryAgain: Prøv å logge på med