AdvancedSearch: Pesquisa avançada 
AdvancedSearchTooltip: Selecionar filtros de conteúdo
BreadcrumbsProductDocumentationHome: Início da documentação do produto
BreadcrumbsSearch: Pesquisar
Cancel: Cancelar
Close: Fechar
DeleteText: Excluir
ErrorOccured: Erro
FilterUsers: Usuários de filtro:
FoundationLoginOnly: Entrar
FoundationLoginRegister: Entrar / Registrar-se
HandlerAdminOnlyAdmin: Acesso negado
HandlerBundlePageAltCSHResult: Tópico de CSH alternativo encontrado
HandlerCategoriesCategoryXMLFileUploaded: Upload do Arquivo XML de categoria concluído
HandlerClassificationUpdated: Mapa de classificação atualizado
HandlerClassificationXMLFile: Mapa de classificação atualizado
HandlerCommentsComments: comentários
HandlerCommentsOneComment: 1 comentário
HandlerCommentsPostedCommentOn: publicou um comentário em:
HandlerContentRolesAreYouSureDelete: Tem certeza de que deseja excluir esta Função de conteúdo?
HandlerContentRolesCRDeleted: Função de conteúdo excluída
HandlerContentRolesErrorDeleting: Erro. A função de conteúdo não foi excluída.
HandlerCshAlternateCSHTopicFound: Tópico de CSH alternativo encontrado
HandlerCshCSHRulesUpdated: Regras de CSH atualizadas
HandlerCshInvalidAliases: Chaves do alias inválidas encontradas no URL de CSH
HandlerCshInvalidCSHRulesFile: Arquivo de Regras de CSH inválido
HandlerCshNewCshFile: Faça upload do novo Arquivo de configuração de CSH
HandlerCshReservedAliasesUsed: Aliases reservados usados no Arquivo de configuração de CSH
HandlerCustomError400H2: 400
HandlerCustomError400H3: Solicitação inválida
HandlerCustomError401H2: 401
HandlerCustomError401H3: Não autorizado
HandlerCustomError403H2: 403
HandlerCustomError403H3: Proibido
HandlerCustomError404H2: 404
HandlerCustomError404H3: Não encontrado
HandlerCustomError405H2: 405
HandlerCustomError405H3: Método não permitido
HandlerCustomError500H2: 500
HandlerCustomError500H3: Erro interno do servidor
HandlerFontoDocumentSaved: Documento salvo
HandlerFontoErrorGeneratingUUID: Erro ao gerar UUID
HandlerFontoErrorParsingID: Erro ao analisar ID
HandlerFontoErrorParsingXML: Erro ao transformar o XML
HandlerFontoErrorParsingXMLToDocument: Erro ao transformar o XML em Documento
HandlerFontoNoFileFound: Arquivo não encontrado
HandlerFontoNoIDFound: ID não encontrada
HandlerFontoUntitledFromCursor: Sem título - do Cursor
HandlerGroupsErrorReadingGroupID: Erro ao ler ID de grupo
HandlerGroupsGroupUpdated: Grupo atualizado
HandlerGroupsMustUseUniqueGroupName: É necessário usar um nome de grupo único
HandlerGroupsNoGroupNameFound: Nenhum nome de grupo encontrado
HandlerGroupsUnableAssignRole: Não foi possível atribuir função
HandlerHowtoContent: Conteúdo
HandlerHowtoDeleted: Artigo excluído
HandlerHowtoInsufficientPermissions: Permissões insuficientes para editar este Artigo
HandlerHowtoSaved: Salvo
HandlerHowtoTitle: Título
HandlerHtmlEmptyMyDocs: Esvaziar Meus Documentos
HandlerLangDefaultLanguageCodeFileUpdated: Arquivo do código de idioma padrão atualizado
HandlerLangNewLangFile: Faça upload do Novo arquivo de código de idioma padrão
HandlerMyPubSourcePublication: Publicação de origem
HandlerProfileDisplayName: Nome de exibição
HandlerProfileScreenName: Nome da tela
HandlerProfileUpdated: Perfil atualizado
HandlerProfileUsernameInUse: Nome de usuário existente
HandlerRatingsInvalidRating: Classificação inválida
HandlerRatingsRatingRecorded: A sua classificação foi registrada
HandlerRatingsRatingUpdated: A sua classificação foi atualizada
HandlerRolesErrorReadingRoleID: Erro ao ler ID de função
HandlerRolesMustUseUniqueRoleName: Use um nome de função único
HandlerRolesNoRoleNameFound: Nenhum nome de função encontrado
HandlerRolesNotEnoughAdminUsersRemaining: Não foi possível atribuir usuários
HandlerRolesSelectedPermissionsLessThenDefault: Não foi possível atribuir permissões: O total de permissões selecionadas é menor do que o conjunto de permissões padrão
HandlerSearchAllResults: Todos os resultados
HandlerSearchNoResultsMsgTryFollowing: Nenhum resultado encontrado. Tente o seguinte:
HandlerSearchNoResultsMsgSpelledCorrectly: Certifique-se de que todas as palavras estão escritas corretamente.
HandlerSearchNoResultsMsgTryDifferent: Tente palavras-chave diferentes.
HandlerSearchNoResultsMsgMoreGeneral: Tente palavras-chave mais gerais.
HandlerSearchNoResultsMsgNoFindProdVer: Não encontrar o seu produto ou versão mais recente? Vá para a Segurança ServicePortal Intel.
HandlerSearchNoResults: Nenhum resultado
HandlerSearchOneResult: Um resultado
HandlerSitemapFile: Arquivo do mapa do site
HandlerSitemapFileUploaded: Mapa do site atualizado com êxito.
HandlerSubjectSchemeInvalidSubjectSchemeLocalizationFile: Arquivo da localização do esquema do assunto inválido
HandlerSubjectSchemeLangDeleted lang@Text: Arquivo da localização de #{lang} excluído
HandlerSubjectSchemeLangsAvailable: Idiomas disponíveis
HandlerSubjectSchemeLangsDeleteConfirm: Tem certeza de que deseja excluir o Arquivo da localização? 
HandlerSubjectSchemeLangsDeleteError: Erro ao excluir o arquivo da localização.
HandlerSubjectSchemeLangsNewFile: Fazer upload do Novo arquivo da localização do esquema do assunto
HandlerSubjectSchemeLangUpdated lang@Text: Arquivo da localização de #{lang} atualizado
HandlerSubjectSchemeLangUploaded lang@Text: Upload do Arquivo da localização de #{lang} concluído 
HandlerSubjectSchemeProblemOccurredWhileUploadingSubjectScheme: Ocorreu um problema durante o upload do Esquema do assunto.
HandlerSubjectSchemeSubjectSchemeUploadedSuccessfully: Upload do esquema do assunto concluído com êxito
HandlerSubjectSchemeUnknownLanguageCode: Código de idioma desconhecido
HandlerSubjectSchemeUpdated: Esquema do assunto atualizado
HandlerSubjectSchemeXMLFile: Arquivo XML do esquema do assunto
HandlerUploadBundleBundle: pacote
HandlerUploadBundleDeleteError x@Text: Erro ao excluir #{x}
HandlerUploadBundleDeleteSuccess x@Text: #{x} excluído com êxito
HandlerUploadBundleError: Erro
HandlerUploadBundleErrorPleaseUpdateSuiteBundleVersion: Erro - Atualize a sua versão do pacote
HandlerUploadBundleNoContentToDelete x@Text: Nenhum conteúdo a excluir em #{x} 
HandlerUploadBundleOneBundleError: Erro ao popular o pacote do upload
HandlerUploadBundlePublicationUploadedSuccessfully: Upload da publicação concluído com êxito
HandlerUploadBundleSheaf: sheaf
HandlerUsersAddedSuccess: Usuário adicionado com êxito
HandlerUsersBadEmail: Aquele endereço de e-mail não está registrado
HandlerUsersCRCreated: Grupo de função de conteúdo criado
HandlerUsersCRGroupNameInUse: Esse nome de Função de conteúdo já está em uso
HandlerUsersCRSetGroupName: Defina um nome para este Grupo de função de conteúdo
HandlerUsersCRUpdated: Grupo de função de conteúdo atualizado
HandlerUsersDefineCR: Definir Novo grupo de função de conteúdo
HandlerUsersDeleteSuccess: Usuário excluído com êxito
HandlerUsersEmailError: Erro ao enviar e-mail de redefinição de senha
HandlerUsersInvalidToken: Token inválido
HandlerUsersNoResetToken: Nenhum token de redefinição
HandlerUsersNoRoleIdFound: Nenhum id de função encontrado
HandlerUsersPasswordEmailSent: E-mail de redefinição de senha enviado
HandlerUsersRegisterSuccess: Usuário registrado com êxito
HandlerUsersResetPasswordError: Erro ao redefinir senha
HandlerUsersRolesUpdated: Funções de usuário atualizadas
HandlerUsersUnableToAssignUserPermissionRole: Não foi possível atribuir função de permissão ao usuário
HandlerUsersUnknownError: Erro desconhecido
HideTOC: Ocultar Sumário
ImportAddHelperProblemRunningAddHelper: Problemas ao executar addHelper
ImportBundlesTooManyTopics num@Int: Um número máximo de #{show num} tópicos pode ser publicado. Selecione menos tópicos e tente novamente.
ImportElasticAnalyzerError: - Observação: erro no analisador personalizado. Consulte o log para obter detalhes. Usando o analisador padrão. 
ImportElasticErrorRebuilding: Erro ao recriar índice. Consulte o log para obter detalhes.
ImportElasticErrorUpdating: Erro ao atualizar índice. Consulte o log para obter detalhes.
ImportElasticIndexRebuilt x@Text: Índice recriado com êxito #{x}
ImportElasticIndexUpdated x@Text: Índice atualizado com êxito #{x}
ImportElasticNoPagesFound: Nenhuma página encontrada no banco de dados – redefinição de índice.
ImportElasticNoPagesInBundle: Nenhuma página encontrada no upload
ImportInvalidPassword: Senha inválida
ImportRatingsOneRating: 1 Classificação
ImportRatingsRatings: Classificações
ImportRolesPermissionDenied: Permissão negada
ImportSearchNoCategoriesUploaded: Não houve upload de Arquivo XML de categorias
ImportSearchUnknownTopicLink: *** link de tópico desconhecido ***
ImportUsersCaptchaError: reCAPTCHA inválido 
ImportUsersCaptchaParseError: Erro no reCAPTCHA
ImportUsersEmailFieldError: Nenhum campo de e-mail encontrado.
ImportUsersFldEmail: E-mail
ImportUsersFldFirstName: Nome
ImportUsersFldLastName: Sobrenome
ImportUsersFldPassword: Senha
ImportUsersFldReenterPass: Reinserir senha
ImportUsersInvalidPass: Senha inválida: as senhas selecionadas devem ter, no mínimo, oito caracteres, incluindo uma letra maiúscula, uma letra minúscula, um caractere especial e um número.
LoggedInAs email@Text: Entrou como #{email}.
Manuals: Manuais
PDFPage: Página
ProductDocumentationSplashTitle: Documentação do produto 
PublishHowto: Publicar
ResultsPerPage: Resultados por página
ResultsPerPageShow: Mostrar xx por página
Search: Pesquisar na documentação do produto
SearchContent: Pesquisar neste conteúdo
SearchHome: Pesquisar na documentação do produto
ShowTOC: Mostrar Sumário
SSOLoginParamError: Erro com os parâmetros de entrada de SSO
SSOLoginTryAgain: Tente entrar novamente com
SwitchLang: Alterar idioma
TemplaesBundlesTitle: Biblioteca de documentação
TemplateAddHelperCancel: Cancelar
TemplateAddHelperSave: Salvar
TemplateAddHelperSaveAndClose: Salvar e fechar
TemplateAddUserAddUser: Adicionar usuário
TemplateAddUserCancel: Cancelar
TemplateAddUserPasswordMessage: As senhas devem ter, no mínimo, oito caracteres, incluindo uma letra maiúscula, uma letra minúscula, um caractere especial e um número.
TemplateAdminArticleManagement: Gerenciamento de artigo
TemplateAdminContentRoleGroups: Grupos de função de conteúdo
TemplateAdminCSHConfigFile: Fazer download ou atualizar arquivo de Configuração de CSH
TemplateAdminElasticReindex: Recriar índice de pesquisa
TemplateAdminExportComments: Exportar comentários
TemplateAdminExportRatings: Exportar classificações
TemplateAdminManageManuals: Gerenciar manuais
TemplateAdminManageResourceManuals: Gerenciar pacotes de recursos
TemplateAdminResourceIdCsv: Fazer download do arquivo do Excel de ResourceIds
TemplateAdminSitemap: Gerenciar mapa do site
TemplateAdminSubjectSchemeLocalization: Gerenciar Localização do esquema do assunto
TemplateAdminTitle: Administração
TemplateAdminUploadCategoryXML: Gerenciar Arquivo XML de categoria
TemplateAdminUploadCategoryXml: Fazer o upload de um novo Arquivo XML de categoria
TemplateAdminUploadNewLangFile: Fazer upload de um novo Arquivo de código de idioma padrão
TemplateAdminUploadSubjectScheme: Gerenciar Esquema do assunto
TemplateAdminUserGroups: Grupos de usuários
TemplateAdminUserManagement: Gerenciamento de usuários
TemplateAdminUserRoles: Funções do usuário
TemplateBundlePageCollapse: Recolher
TemplateBundlePageCollapseTooltip: Recolher todos os títulos
TemplateBundlePageComments: Comentários
TemplateBundlePageContents: Conteúdo
TemplateBundlePageExpand: Expandir
TemplateBundlePageExpandTooltip: Expandir Sumário
TemplateBundlePageFeedback: Comentários
TemplateBundlePageFeedbackThankYou: Obrigado! Os seus comentários foram enviados. 
TemplateBundlePageFeedbackTooltip: Enviar comentários
TemplateBundlePageFilterTitle: Selecionar uma ou mais opções
TemplateBundlePageNext: Avançar
TemplateBundlePageNextTopicTooltip: Ir para o próximo tópico
TemplateBundlePageNo: Não
TemplateBundlePagePrevious: Voltar 
TemplateBundlePagePrevTopicTooltip: Ir para o tópico anterior
TemplateBundlePagePrint: Imprimir
TemplateBundlePagePrintTooltip: Imprimir tópico
TemplateBundlePagePrivacy: Para proteger a sua privacidade, não inclua as suas informações de contato nos comentários. Revise a nossa política de privacidade.
TemplateBundlePageProvideFeedbackCharsLeft: 500 caracteres restantes
TemplateBundlePageProvideFeedbackTooltip: Fornecer comentários
TemplateBundlePageSaveAsPDF: Salvar como PDF
TemplateBundlePageSavePDFTooltip: Salvar como PDF
TemplateBundlePageSaveSelectedTopic: Salvar tópico selecionado
TemplateBundlePageSaveSelectedTopicAndSubtopics: Salvar tópico e subtópicos selecionados
TemplateBundlePageSeeAlso: Ver também
TemplateBundlePageSend: Enviar
TemplateBundlePageSendLink: Enviar
TemplateBundlePageSendLinkTooltip: Enviar link para tópico
TemplateBundlePageSubmit: Enviar
TemplateBundlePageWasThisInformationHelpful: Essa informação foi útil?
TemplateBundlePageYEs: Sim
TemplateBundlesDeleteLanguage: Excluir idioma
TemplateBundlesDeleteManual: Excluir manual
TemplateBundlesDownload: Fazer download do pacote
TemplateBundlesDownloadClassification: Fazer download do XML de classificação
TemplateBundlesHiddenBundle: Manual oculto
TemplateBundlesSearchManuals: Pesquisar manuais
TemplateBundlesUploadClassification: Fazer upload de XML de classificação
TemplateClassificationForManual: Para manual
TemplateClassificationUploadClassificationMap: Fazer upload do XML do mapa de classificação
TemplateClassificationWarnReindex: OBSERVAÇÃO: o upload de um mapa de classificação reindexará todo o site. A conclusão deste processo pode levar vários minutos.
TemplateContentRolesCRGroups: Grupos de função de conteúdo
TemplateContentRolesDefineNewCR: Definir nova função de conteúdo
TemplateDefaultLayoutAdministration: Administração
TemplateDefaultLayoutArticles: Artigos
TemplateDefaultLayoutBrowseDocumentation: Procurar
TemplateDefaultLayoutDocumentation: Biblioteca de documentação
TemplateDefaultLayoutHome: Início
TemplateDefaultLayoutLanguages: United States - English
TemplateDefaultLayoutLinksCareers: Carreiras
TemplateDefaultLayoutLinksContactUs: Fale conosco
TemplateDefaultLayoutLinksIntelCorp: © Intel Corporation
TemplateDefaultLayoutLinksLegalContractsandTerms: Termos e contratos legais
TemplateDefaultLayoutLinksLegalNotices: Avisos legais  
TemplateDefaultLayoutLinksPrivacy: Privacidade
TemplateDefaultLayoutLinksSiteMap: Mapa do site
TemplateDefaultLayoutLinksWebsiteFeedback: Comentários sobre o site
TemplateDefaultLayoutLogout: Sair
TemplateDefaultLayoutProfile: Perfil
TemplateDefaultLayoutVideos: Vídeos
TemplateFilterCurrentPublication: Publicação atual
TemplateRequestResetPasswordEmail: E-mail
TemplateRequestResetPasswordSubmit: Solicitar e-mail de redefinição de senha
TemplateSearchCurrentPublication name@Text: A pesquisa atual limita-se à publicação de '#{name}'
TemplateSearchPageClearTooltip: Limpar filtros
TemplateSearchPageFirstPageTooltip: Ir para a primeira página
TemplateSearchPageLastPageTooltip: Ir para a última página
TemplateSearchPageNextPageTooltip: Ir para a próxima página
TemplateSearchPagePrevPageTooltip: Ir para a página anterior
TemplateSearchPublicationTitle: Publicação
TemplateSearchSortbyCreatedAsc: Data de criação - crescente
TemplateSearchSortbyCreatedDec: Data de criação - Decrescente
TemplateSearchSortbyScore: Pontuação
TemplateSearchSortbyUpdatedAsc: Data da adição - crescente
TemplateSearchSortbyUpdatedDec: Data da adição - decrescente
TemplateSearchSortbyViews: Número de exibições
TemplatesSearchPageClear: Limpar
TemplatesSearchPageCurrentResults: Resultados xx-yy de zzz
TemplatesSearchPageRefilneResults: Refinar resultados
TemplatesSearchPageResultUpdated: Atualizado
TemplateUploadSitemapDisable: Desativar mapa do site
TemplateUploadSitemapDisabled: Mapa do site desativado
TemplateUploadSitemapDisabledWord: Desativado
TemplateUploadSitemapDownloadSitemap: Fazer download de sitemap.xml
TemplateUploadSitemapEnable: Ativar mapa do site
TemplateUploadSitemapEnabled: Mapa do site ativado
TemplateUploadSitemapEnabledWord: Ativado
TemplateUploadSitemapLegend: Fazer upload de sitemap.xml
TemplateUploadSitemapStatus sts@Text: O mapa do site é #{sts}
TextPass txt@Text: #{txt}
Upload: Fazer upload
UploadLink: Fazer upload da publicação
YesodAuthStormPathSSOErrorOccured: Erro
YesodAuthStormPathSSOLoginParamError: Erro com os parâmetros de entrada de SSO
YesodAuthStormPathSSOLoginTryAgain: Tente entrar novamente com