AdvancedSearch: Pesquisa avançada 
AdvancedSearchTooltip: Selecionar filtros de conteúdo
BreadcrumbsProductDocumentationHome: Página principal da documentação do produto
BreadcrumbsSearch: Pesquisar
Cancel: Cancelar
Close: Fechar
DeleteText: Eliminar
ErrorOccured: Ocorreu um erro
FilterUsers: Filtrar utilizadores:
FoundationLoginOnly: Iniciar sessão
FoundationLoginRegister: Iniciar sessão/Registar-se
HandlerAdminOnlyAdmin: Acesso negado
HandlerBundlePageAltCSHResult: Tópico CSH alternativo encontrado
HandlerCategoriesCategoryXMLFileUploaded: Ficheiro XML da categoria carregado
HandlerClassificationUpdated: Mapa de classificação atualizado
HandlerClassificationXMLFile: Mapa de classificação atualizado
HandlerCommentsComments: comentários
HandlerCommentsOneComment: 1 comentário
HandlerCommentsPostedCommentOn: publicou um comentário em:
HandlerContentRolesAreYouSureDelete: Tem a certeza de que pretende eliminar esta função de conteúdo?
HandlerContentRolesCRDeleted: Função de conteúdo eliminada
HandlerContentRolesErrorDeleting: Ocorreu um problema. A função de conteúdo não foi eliminada.
HandlerCshAlternateCSHTopicFound: Tópico CSH alternativo encontrado
HandlerCshCSHRulesUpdated: Regras CSH atualizadas
HandlerCshInvalidAliases: Chaves de alias inválidas encontradas no URL CSH
HandlerCshInvalidCSHRulesFile: Ficheiro de regras CSH inválido
HandlerCshNewCshFile: Carregar novo ficheiro de configuração CSH
HandlerCshReservedAliasesUsed: Aliases reservados utilizados no ficheiro de configuração CSH
HandlerCustomError400H2: 400
HandlerCustomError400H3: Pedido inválido
HandlerCustomError401H2: 401
HandlerCustomError401H3: Não autorizado
HandlerCustomError403H2: 403
HandlerCustomError403H3: Proibido
HandlerCustomError404H2: 404
HandlerCustomError404H3: Não encontrado
HandlerCustomError405H2: 405
HandlerCustomError405H3: Método não permitido
HandlerCustomError500H2: 500
HandlerCustomError500H3: Erro no servidor interno
HandlerFontoDocumentSaved: Documento guardado
HandlerFontoErrorGeneratingUUID: Erro ao gerar UUID
HandlerFontoErrorParsingID: Erro ao analisar ID
HandlerFontoErrorParsingXML: Erro ao analisar XML
HandlerFontoErrorParsingXMLToDocument: Erro ao analisar XML para documento
HandlerFontoNoFileFound: Ficheiro não encontrado
HandlerFontoNoIDFound: ID não encontrado
HandlerFontoUntitledFromCursor: Sem título – do Cursor
HandlerGroupsErrorReadingGroupID: Erro ao ler ID de grupo
HandlerGroupsGroupUpdated: Grupo atualizado
HandlerGroupsMustUseUniqueGroupName: É necessário um nome do grupo exclusivo
HandlerGroupsNoGroupNameFound: Nenhum nome do grupo encontrado
HandlerGroupsUnableAssignRole: Não foi possível atribuir a função
HandlerHowtoContent: Conteúdo
HandlerHowtoDeleted: Artigo eliminado
HandlerHowtoInsufficientPermissions: Permissões insuficientes para editar este artigo
HandlerHowtoSaved: Guardado
HandlerHowtoTitle: Título
HandlerHtmlEmptyMyDocs: Esvaziar MyDocs
HandlerLangDefaultLanguageCodeFileUpdated: Ficheiro de código de idioma predefinido atualizado
HandlerLangNewLangFile: Carregar novo ficheiro de código de idioma predefinido
HandlerMyPubSourcePublication: Publicação de origem
HandlerProfileDisplayName: Nome a apresentar
HandlerProfileScreenName: Pseudónimo
HandlerProfileUpdated: Perfil atualizado
HandlerProfileUsernameInUse: O nome de utilizador já existe
HandlerRatingsInvalidRating: Classificação inválida
HandlerRatingsRatingRecorded: A sua classificação foi registada
HandlerRatingsRatingUpdated: A sua classificação foi atualizada
HandlerRolesErrorReadingRoleID: Erro ao ler ID da função
HandlerRolesMustUseUniqueRoleName: Utilize um nome da função exclusivo
HandlerRolesNoRoleNameFound: Nenhum nome da função encontrado
HandlerRolesNotEnoughAdminUsersRemaining: Não foi possível atribuir utilizadores
HandlerRolesSelectedPermissionsLessThenDefault: Não foi possível atribuir permissões. As permissões selecionadas são inferiores ao conjunto de permissões predefinido.
HandlerSearchAllResults: Todos os resultados
HandlerSearchNoResults: Não há resultados
HandlerSearchOneResult: Um resultado
HandlerSitemapFile: Ficheiro do mapa do site
HandlerSitemapFileUploaded: Mapa do site atualizado com êxito.
HandlerSubjectSchemeInvalidSubjectSchemeLocalizationFile: Ficheiro de localização do esquema do assunto inválido
HandlerSubjectSchemeLangDeleted lang@Text: #{lang} Ficheiro de localização eliminado
HandlerSubjectSchemeLangsAvailable: Idiomas disponíveis
HandlerSubjectSchemeLangsDeleteConfirm: Tem a certeza de que pretende eliminar o ficheiro de localização? 
HandlerSubjectSchemeLangsDeleteError: Ocorreu um erro ao eliminar o ficheiro de localização.
HandlerSubjectSchemeLangsNewFile: Carregar novo ficheiro de localização SubjectScheme
HandlerSubjectSchemeLangUpdated lang@Text: #{lang} Ficheiro de localização atualizado
HandlerSubjectSchemeLangUploaded lang@Text: #{lang} Ficheiro de localização carregado 
HandlerSubjectSchemeProblemOccurredWhileUploadingSubjectScheme: Ocorreu um problema ao carregar o Esquema do assunto.
HandlerSubjectSchemeSubjectSchemeUploadedSuccessfully: Esquema do assunto carregado com êxito
HandlerSubjectSchemeUnknownLanguageCode: Código de idioma desconhecido
HandlerSubjectSchemeUpdated: Esquema do assunto atualizado
HandlerSubjectSchemeXMLFile: Ficheiro XML do esquema do assunto
HandlerUploadBundleBundle: pacote
HandlerUploadBundleDeleteError x@Text: Erro ao eliminar #{x}
HandlerUploadBundleDeleteSuccess x@Text: #{x} eliminado com êxito
HandlerUploadBundleError: Erro
HandlerUploadBundleErrorPleaseUpdateSuiteBundleVersion: Erro – Atualize a versão do pacote
HandlerUploadBundleNoContentToDelete x@Text: Não há conteúdo a eliminar em #{x} 
HandlerUploadBundleOneBundleError: Erro ao preencher o pacote carregado
HandlerUploadBundlePublicationUploadedSuccessfully: Publicação carregada com êxito
HandlerUploadBundleSheaf: sheaf
HandlerUsersAddedSuccess: Utilizador adicionado com êxito
HandlerUsersBadEmail: Esse endereço de correio eletrónico não está registado
HandlerUsersCRCreated: Grupo de funções de conteúdo criado
HandlerUsersCRGroupNameInUse: O nome da Função de conteúdo já está a ser utilizado
HandlerUsersCRSetGroupName: Defina um nome para este Grupo de funções de conteúdo
HandlerUsersCRUpdated: Grupo de funções de conteúdo atualizado
HandlerUsersDefineCR: Definir novo grupo de funções de conteúdo
HandlerUsersDeleteSuccess: Utilizador eliminado com êxito
HandlerUsersEmailError: Ocorreu um erro ao enviar a mensagem de correio eletrónico de reposição de palavra-passe
HandlerUsersInvalidToken: Token inválido
HandlerUsersNoResetToken: Nenhum token de reposição
HandlerUsersNoRoleIdFound: Nenhum ID da função encontrado
HandlerUsersPasswordEmailSent: Mensagem de correio eletrónico de reposição de palavra-passe enviada
HandlerUsersRegisterSuccess: Utilizador registado com êxito
HandlerUsersResetPasswordError: Ocorreu um erro de reposição de palavra-passe
HandlerUsersRolesUpdated: Funções de utilizador atualizadas
HandlerUsersUnableToAssignUserPermissionRole: Não foi possível atribuir a função de permissão do utilizador
HandlerUsersUnknownError: Erro desconhecido
HideTOC: Ocultar índice
ImportAddHelperProblemRunningAddHelper: Problema ao executar addHelper
ImportBundlesTooManyTopics num@Int: É possível publicar, no máximo, #{show num} tópicos. Selecione menos tópicos e tente novamente.
ImportElasticAnalyzerError: – Nota: erro do analisador personalizado, consulte o registo para obter detalhes. A utilizar o analisador predefinido. 
ImportElasticErrorRebuilding: Erro ao reconstruir o índice, consulte o registo para obter mais detalhes.
ImportElasticErrorUpdating: Erro ao atualizar o índice, consulte o registo para obter mais detalhes.
ImportElasticIndexRebuilt x@Text: Índice reconstruído com êxito #{x}
ImportElasticIndexUpdated x@Text: Índice atualizado com êxito #{x}
ImportElasticNoPagesFound: Não foram encontradas páginas na base de dados, índice reposto.
ImportElasticNoPagesInBundle: Não foram encontradas páginas no carregamento
ImportInvalidPassword: Palavra-passe inválida
ImportRatingsOneRating: 1 classificação
ImportRatingsRatings: Classificações
ImportRolesPermissionDenied: Permissão negada
ImportSearchNoCategoriesUploaded: Nenhum ficheiro XML de categorias carregado
ImportSearchUnknownTopicLink: *** ligação para tópico desconhecida ***
ImportUsersCaptchaError: reCAPTCHA inválido 
ImportUsersCaptchaParseError: Erro do reCAPTCHA
ImportUsersEmailFieldError: Nenhum campo de correio eletrónico encontrado.
ImportUsersFldEmail: Correio eletrónico
ImportUsersFldFirstName: Nome próprio
ImportUsersFldLastName: Apelido
ImportUsersFldPassword: Palavra-passe
ImportUsersFldReenterPass: Reintroduzir palavra-passe
ImportUsersInvalidPass: Palavra-passe inválida: a palavra-passe selecionada tem de ter, no mínimo, 8 carateres, incluindo, no mínimo, 1 letra maiúscula, 1 letra minúscula, 1 caráter especial e 1 número.
LoggedInAs email@Text: Com sessão iniciada como #{email}.
Manuals: Manuais
PDFPage: Página
ProductDocumentationSplashTitle: Documentação do produto 
PublishHowto: Publicar
ResultsPerPage: Resultados por página
ResultsPerPageShow: Mostrar xx por página
Search: Pesquisar documentação do produto
SearchContent: Pesquisar este conteúdo
SearchHome: Pesquisar documentação do produto
ShowTOC: Mostrar índice
SSOLoginParamError: Ocorreu um erro com os parâmetros de início de sessão SSO
SSOLoginTryAgain: Experimente iniciar sessão novamente com
SwitchLang: Alterar idioma
TemplaesBundlesTitle: Biblioteca de documentação
TemplateAddHelperCancel: Cancelar
TemplateAddHelperSave: Guardar
TemplateAddHelperSaveAndClose: Guardar e fechar
TemplateAddUserAddUser: Adicionar utilizador
TemplateAddUserCancel: Cancelar
TemplateAddUserPasswordMessage: A palavra-passe tem de ter, no mínimo, 8 carateres, incluindo, no mínimo, 1 letra maiúscula, 1 letra minúscula, 1 caráter especial e 1 número.
TemplateAdminArticleManagement: Gestão de artigos
TemplateAdminContentRoleGroups: Grupos de funções de conteúdo
TemplateAdminCSHConfigFile: Transferir ou atualizar ficheiro de configuração CSH
TemplateAdminElasticReindex: Reconstruir índice de pesquisa
TemplateAdminExportComments: Exportar comentários
TemplateAdminExportRatings: Exportar classificações
TemplateAdminManageManuals: Gerir manuais
TemplateAdminManageResourceManuals: Gerir pacotes de recursos
TemplateAdminResourceIdCsv: Transferir ficheiro Excel ResourceIds
TemplateAdminSitemap: Gerir mapa do site
TemplateAdminSubjectSchemeLocalization: Gerir localização do esquema do assunto
TemplateAdminTitle: Administração
TemplateAdminUploadCategoryXML: Gerir ficheiro XML da categoria
TemplateAdminUploadCategoryXml: Carregar um novo ficheiro XML da categoria
TemplateAdminUploadNewLangFile: Carregar um novo ficheiro de código de idioma predefinido
TemplateAdminUploadSubjectScheme: Gerir esquema do assunto
TemplateAdminUserGroups: Grupos de utilizadores
TemplateAdminUserManagement: Gestão de utilizadores
TemplateAdminUserRoles: Funções de utilizador
TemplateBundlePageCollapse: Fechar
TemplateBundlePageCollapseTooltip: Fechar todos os títulos
TemplateBundlePageComments: Comentários
TemplateBundlePageContents: Índice
TemplateBundlePageExpand: Expandir
TemplateBundlePageExpandTooltip: Expandir índice
TemplateBundlePageFeedback: Comentários
TemplateBundlePageFeedbackThankYou: Obrigado! Os seus comentários foram enviados. 
TemplateBundlePageFeedbackTooltip: Submeter comentários
TemplateBundlePageFilterTitle: Selecionar uma ou mais opções
TemplateBundlePageNext: Seguinte
TemplateBundlePageNextTopicTooltip: Aceder ao tópico seguinte
TemplateBundlePageNo: Não
TemplateBundlePagePrevious: Anterior 
TemplateBundlePagePrevTopicTooltip: Aceder ao tópico anterior
TemplateBundlePagePrint: Imprimir
TemplateBundlePagePrintTooltip: Imprimir tópico
TemplateBundlePagePrivacy: Para proteger a sua privacidade, não inclua informações de contacto nos comentários. Consulte a nossa Política de Privacidade.
TemplateBundlePageProvideFeedbackTooltip: Enviar comentários
TemplateBundlePageSaveAsPDF: Guardar como PDF
TemplateBundlePageSavePDFTooltip: Guardar como PDF
TemplateBundlePageSaveSelectedTopic: Guardar tópico selecionado
TemplateBundlePageSaveSelectedTopicAndSubtopics: Guardar tópico e subtópicos selecionados
TemplateBundlePageSeeAlso: Consultar também
TemplateBundlePageSend: Enviar
TemplateBundlePageSendLink: Enviar
TemplateBundlePageSendLinkTooltip: Enviar ligação para o tópico
TemplateBundlePageSubmit: Submeter
TemplateBundlePageWasThisInformationHelpful: Estas informações foram úteis?
TemplateBundlePageYEs: Sim
TemplateBundlesDeleteLanguage: Eliminar idioma
TemplateBundlesDeleteManual: Eliminar manual
TemplateBundlesDownload: Transferir pacote
TemplateBundlesDownloadClassification: Transferir XML de classificação
TemplateBundlesHiddenBundle: Manual oculto
TemplateBundlesSearchManuals: Pesquisar manuais
TemplateBundlesUploadClassification: Carregar XML de classificação
TemplateClassificationForManual: Para o manual
TemplateClassificationUploadClassificationMap: Carregar XML do mapa de classificação
TemplateClassificationWarnReindex: NOTA: carregar um mapa de classificação fará com que todo o site seja reindexado. Esta ação pode demorar alguns minutos.
TemplateContentRolesCRGroups: Grupos de funções de conteúdo
TemplateContentRolesDefineNewCR: Definir nova função de conteúdo
TemplateDefaultLayoutAdministration: Administração
TemplateDefaultLayoutArticles: Artigos
TemplateDefaultLayoutBrowseDocumentation: Procurar
TemplateDefaultLayoutDocumentation: Biblioteca de documentação
TemplateDefaultLayoutHome: Página principal
TemplateDefaultLayoutLanguages: United States - English
TemplateDefaultLayoutLinksCareers: Empregos
TemplateDefaultLayoutLinksContactUs: Contacte-nos
TemplateDefaultLayoutLinksIntelCorp: © Intel Corporation
TemplateDefaultLayoutLinksLegalContractsandTerms: Termos e contratos legais
TemplateDefaultLayoutLinksLegalNotices: Avisos legais 
TemplateDefaultLayoutLinksPrivacy: Privacidade
TemplateDefaultLayoutLinksSiteMap: Mapa do site
TemplateDefaultLayoutLinksWebsiteFeedback: Comentários acerca do Web site
TemplateDefaultLayoutLogout: Terminar sessão
TemplateDefaultLayoutProfile: Perfil
TemplateDefaultLayoutVideos: Vídeos
TemplateFilterCurrentPublication: Publicação atual
TemplateRequestResetPasswordEmail: Correio eletrónico
TemplateRequestResetPasswordSubmit: Solicitar mensagem de correio eletrónico de reposição de palavra-passe
TemplateSearchCurrentPublication name@Text: A pesquisa atual está limitada à publicação "#{name}'"
TemplateSearchPageClearTooltip: Limpar filtros
TemplateSearchPageFirstPageTooltip: Ir para a primeira página
TemplateSearchPageLastPageTooltip: Ir para a última página
TemplateSearchPageNextPageTooltip: Ir para a página seguinte
TemplateSearchPagePrevPageTooltip: Ir para a página anterior
TemplateSearchPublicationTitle: Publicação
TemplateSearchSortbyCreatedAsc: Data de criação – ordem ascendente
TemplateSearchSortbyCreatedDec: Data de criação – ordem descendente
TemplateSearchSortbyScore: Pontuação
TemplateSearchSortbyUpdatedAsc: Data de adição – ordem ascendente
TemplateSearchSortbyUpdatedDec: Data de adição – ordem descendente
TemplateSearchSortbyViews: Número de visitas
TemplatesSearchPageClear: Limpar
TemplatesSearchPageCurrentResults: Resultados xx-yy de zzz
TemplatesSearchPageRefilneResults: Refinar resultados
TemplatesSearchPageResultUpdated: Atualizado
TemplateUploadSitemapDisable: Desativar mapa do site
TemplateUploadSitemapDisabled: Mapa do site desativado
TemplateUploadSitemapDisabledWord: Desativado
TemplateUploadSitemapDownloadSitemap: Transferir sitemap.xml
TemplateUploadSitemapEnable: Ativar mapa do site
TemplateUploadSitemapEnabled: Mapa do site ativado
TemplateUploadSitemapEnabledWord: Ativado
TemplateUploadSitemapLegend: Carregar sitemap.xml
TemplateUploadSitemapStatus sts@Text: O mapa do site é #{sts}
TemplTemplateBundlePageProvideFeedbackTooltip: Submeter comentários
TextPass txt@Text: #{txt}
Upload: Carregar
UploadLink: Carregar publicação
YesodAuthStormPathSSOErrorOccured: Ocorreu um erro
YesodAuthStormPathSSOLoginParamError: Ocorreu um erro com os parâmetros de início de sessão SSO
YesodAuthStormPathSSOLoginTryAgain: Experimente iniciar sessão novamente com