AdvancedSearch: Avancerad sökning 
AdvancedSearchTooltip: Välj innehållsfilter
BreadcrumbsProductDocumentationHome: Startsida för produktdokumentationen
BreadcrumbsSearch: Sök
Cancel: Avbryt
Close: Stäng
DeleteText: Ta bort
ErrorOccured: Ett fel inträffade
FilterUsers: Filtrera användare:
FoundationLoginOnly: Logga in
FoundationLoginRegister: Logga in/registrera
HandlerAdminOnlyAdmin: Åtkomst nekades
HandlerBundlePageAltCSHResult: Ett annat CSH-avsnitt hittades
HandlerCategoriesCategoryXMLFileUploaded: XML-fil för kategorin överfördes
HandlerClassificationUpdated: Klassificeringskartan har uppdaterats
HandlerClassificationXMLFile: Uppdaterad klassificeringskarta
HandlerCommentsComments: kommentarer
HandlerCommentsOneComment: 1 kommentar
HandlerCommentsPostedCommentOn: publicerade en kommentar den:
HandlerContentRolesAreYouSureDelete: Vill du ta bort den här innehållsrollen?
HandlerContentRolesCRDeleted: Innehållsrollen togs bort
HandlerContentRolesErrorDeleting: Ett problem uppstod. Innehållsrollen togs inte bort.
HandlerCshAlternateCSHTopicFound: Ett annat CSH-avsnitt hittades
HandlerCshCSHRulesUpdated: CSH-regler uppdaterades
HandlerCshInvalidAliases: Ogiltiga aliasnycklar hittades i CSH-webbadressen
HandlerCshInvalidCSHRulesFile: Ogiltig fil med CSH-regler
HandlerCshNewCshFile: Överför en ny CSH-konfigurationsfil
HandlerCshReservedAliasesUsed: Reserverade alias används i CSH-konfigurationsfilen
HandlerCustomError400H2: 400
HandlerCustomError400H3: Felaktig begäran
HandlerCustomError401H2: 401
HandlerCustomError401H3: Behörighet saknas
HandlerCustomError403H2: 403
HandlerCustomError403H3: Förbjudet
HandlerCustomError404H2: 404
HandlerCustomError404H3: Hittades inte
HandlerCustomError405H2: 405
HandlerCustomError405H3: Metoden är inte tillåten
HandlerCustomError500H2: 500
HandlerCustomError500H3: Internt serverfel
HandlerFontoDocumentSaved: Dokumentet sparades
HandlerFontoErrorGeneratingUUID: Ett fel uppstod när UUID genererades
HandlerFontoErrorParsingID: Ett fel uppstod vid tolkning av ID
HandlerFontoErrorParsingXML: Ett fel uppstod vid tolkning av XML
HandlerFontoErrorParsingXMLToDocument: Ett fel uppstod vid tolkning av XML till dokument
HandlerFontoNoFileFound: Filen hittades inte
HandlerFontoNoIDFound: ID hittades inte
HandlerFontoUntitledFromCursor: Utan namn – från markör
HandlerGroupsErrorReadingGroupID: Ett fel uppstod vid läsning av grupp-ID
HandlerGroupsGroupUpdated: Gruppen uppdaterades
HandlerGroupsMustUseUniqueGroupName: Ett unikt gruppnamn måste användas
HandlerGroupsNoGroupNameFound: Inget gruppnamn hittades
HandlerGroupsUnableAssignRole: Det gick inte att tilldela rollen
HandlerHowtoContent: Innehåll
HandlerHowtoDeleted: Artikeln togs bort
HandlerHowtoInsufficientPermissions: Du har inte tillräcklig behörighet för att redigera den här artikeln
HandlerHowtoSaved: Sparades
HandlerHowtoTitle: Rubrik
HandlerHtmlEmptyMyDocs: Mina dokument är tomt
HandlerLangDefaultLanguageCodeFileUpdated: Kodfilen för standardspråk uppdaterades
HandlerLangNewLangFile: Överför en ny kodfil för standardspråk
HandlerMyPubSourcePublication: Källpublikation
HandlerProfileDisplayName: Visningsnamn
HandlerProfileScreenName: Skärmnamn
HandlerProfileUpdated: Profilen har uppdaterats
HandlerProfileUsernameInUse: Användarnamnet finns redan
HandlerRatingsInvalidRating: Ogiltig klassificering
HandlerRatingsRatingRecorded: Din klassificering har registrerats
HandlerRatingsRatingUpdated: Din klassificering har uppdaterats
HandlerRolesErrorReadingRoleID: Ett fel uppstod vid läsning av roll-ID
HandlerRolesMustUseUniqueRoleName: Använd ett unikt rollnamn
HandlerRolesNoRoleNameFound: Inget rollnamn hittades
HandlerRolesNotEnoughAdminUsersRemaining: Det gick inte att tilldela användare
HandlerRolesSelectedPermissionsLessThenDefault: Det gick inte att tilldela behörigheter: De valda behörigheterna är färre än standardbehörighetsuppsättningen
HandlerSearchAllResults: Alla resultat
HandlerSearchNoResultsMsgTryFollowing: Inga resultat funna. Försök med följande:g:
HandlerSearchNoResultsMsgSpelledCorrectly: Se till att alla ord är rättstavade.
HandlerSearchNoResultsMsgTryDifferent: Försök med olika nyckelord.
HandlerSearchNoResultsMsgMoreGeneral: Försök med fler generella nyckelord.
HandlerSearchNoResultsMsgNoFindProdVer: Hittar inte din produkt eller version? Gå till Intel Security Serviceportal.
HandlerSearchNoResults: Inga resultat
HandlerSearchOneResult: Ett resultat
HandlerSitemapFile: Fil med webbplatskarta
HandlerSitemapFileUploaded: Webbplatskartan uppdaterades.
HandlerSubjectSchemeInvalidSubjectSchemeLocalizationFile: Ogiltig lokaliseringsfil för ämnesschema
HandlerSubjectSchemeLangDeleted lang@Text: #{lang} Lokaliseringsfilen togs bort
HandlerSubjectSchemeLangsAvailable: Tillgängliga språk
HandlerSubjectSchemeLangsDeleteConfirm: Vill du ta bort lokaliseringsfilen? 
HandlerSubjectSchemeLangsDeleteError: Ett fel uppstod när lokaliseringsfilen skulle tas bort.
HandlerSubjectSchemeLangsNewFile: Överför lokaliseringsfil för nytt SubjectScheme
HandlerSubjectSchemeLangUpdated lang@Text: #{lang} Lokaliseringsfilen uppdaterades
HandlerSubjectSchemeLangUploaded lang@Text: #{lang} Lokaliseringsfilen överfördes 
HandlerSubjectSchemeProblemOccurredWhileUploadingSubjectScheme: Ett problem uppstod vid överföringen av ämnesschemat.
HandlerSubjectSchemeSubjectSchemeUploadedSuccessfully: Ämnesschemat överfördes
HandlerSubjectSchemeUnknownLanguageCode: Okänd språkkod
HandlerSubjectSchemeUpdated: Ämnesschemat uppdaterades
HandlerSubjectSchemeXMLFile: XML-fil för ämnesschema
HandlerUploadBundleBundle: paket
HandlerUploadBundleDeleteError x@Text: Fel vid borttagning av #{x}
HandlerUploadBundleDeleteSuccess x@Text: #{x} togs bort
HandlerUploadBundleError: Fel
HandlerUploadBundleErrorPleaseUpdateSuiteBundleVersion: Fel – Uppdatera din paketversion
HandlerUploadBundleNoContentToDelete x@Text: Det finns inte något innehåll att ta bort i #{x} 
HandlerUploadBundleOneBundleError: Ett fel uppstod när det överförda paketet fylldes i
HandlerUploadBundlePublicationUploadedSuccessfully: Publikationen överfördes
HandlerUploadBundleSheaf: sheaf
HandlerUsersAddedSuccess: Användaren har lagts till
HandlerUsersBadEmail: E-postadressen är inte registrerad
HandlerUsersCRCreated: Innehållsrollgruppen skapades
HandlerUsersCRGroupNameInUse: Innehållsrollnamnet används redan
HandlerUsersCRSetGroupName: Ange ett namn på den här innehållsrollgruppen
HandlerUsersCRUpdated: Innehållsrollgruppen uppdaterades
HandlerUsersDefineCR: Definiera en ny innehållsrollgrupp
HandlerUsersDeleteSuccess: Användaren togs bort
HandlerUsersEmailError: Ett fel uppstod när meddelandet för lösenordsåterställning skickades
HandlerUsersInvalidToken: Ogiltig token
HandlerUsersNoResetToken: Ingen återställningstoken
HandlerUsersNoRoleIdFound: Inget roll-ID hittades
HandlerUsersPasswordEmailSent: Ett e-postmeddelande om lösenordsåterställning har skickats
HandlerUsersRegisterSuccess: Användaren har registrerats
HandlerUsersResetPasswordError: Ett fel uppstod när lösenordet skulle återställas
HandlerUsersRolesUpdated: Användarrollerna är uppdaterade
HandlerUsersUnableToAssignUserPermissionRole: Det gick inte att tilldela användarens behörighetsroll
HandlerUsersUnknownError: Okänt fel
HideTOC: Dölj innehållsförteckningen
ImportAddHelperProblemRunningAddHelper: Ett problem uppstod när addHelper kördes
ImportBundlesTooManyTopics num@Int: Maximalt #{show num} avsnitt kan publiceras. Välj färre avsnitt och försök igen.
ImportElasticAnalyzerError: - Obs! Anpassat Analyzer-fel, se loggen för mer information. Använder standard-Analyzer. 
ImportElasticErrorRebuilding: Fel vid återskapande av index – se loggen för mer information.
ImportElasticErrorUpdating: Fel vid uppdatering av index – se loggen för mer information.
ImportElasticIndexRebuilt x@Text: Index har återskapats #{x}
ImportElasticIndexUpdated x@Text: Index har uppdaterats #{x}
ImportElasticNoPagesFound: Inga sidor hittades i databasen – index återställs.
ImportElasticNoPagesInBundle: Inga sidor hittades i överföringen
ImportInvalidPassword: Ogiltigt lösenord
ImportRatingsOneRating: 1 Klassificering
ImportRatingsRatings: Klassificeringar
ImportRolesPermissionDenied: Behörighet nekades
ImportSearchNoCategoriesUploaded: Ingen XML-fil för kategorin överfördes
ImportSearchUnknownTopicLink: *** okänd avsnittslänk ***
ImportUsersCaptchaError: Ogiltig reCAPTCHA 
ImportUsersCaptchaParseError: reCAPTCHA-fel
ImportUsersEmailFieldError: Inget e-postfält hittades.
ImportUsersFldEmail: E-post
ImportUsersFldFirstName: Förnamn
ImportUsersFldLastName: Efternamn
ImportUsersFldPassword: Lösenord
ImportUsersFldReenterPass: Ange lösenordet igen
ImportUsersInvalidPass: Ogiltigt lösenord: Det valda lösenordet måste bestå av minst 8 tecken, inklusive minst 1 stor bokstav, 1 liten bokstav, 1 specialtecken och 1 siffra.
LoggedInAs email@Text: Inloggad som #{email}.
Manuals: Handböcker
PDFPage: Sida
ProductDocumentationSplashTitle: Produktdokumentation 
PublishHowto: Publicera
ResultsPerPage: Resultat per sida
ResultsPerPageShowFirst: Visa
ResultsPerPageShow: per sida
Search: Sök i produktdokumentationen
SearchContent: Sök i det här innehållet
SearchHome: Sök i produktdokumentationen
ShowTOC: Visa innehållsförteckningen
SSOLoginParamError: Ett fel uppstod med SSO-inloggningsparametrarna
SSOLoginTryAgain: Försök logga in igen med
SwitchLang: Ändra språk
TemplaesBundlesTitle: Dokumentationsbibliotek
TemplateAddHelperCancel: Avbryt
TemplateAddHelperSave: Spara
TemplateAddHelperSaveAndClose: Spara och stäng
TemplateAddUserAddUser: Lägg till användare
TemplateAddUserCancel: Avbryt
TemplateAddUserPasswordMessage: Lösenordet måste bestå av minst 8 tecken, inklusive minst 1 stor bokstav, 1 liten bokstav, 1 specialtecken och 1 siffra.
TemplateAdminArticleManagement: Artikelhantering
TemplateAdminContentRoleGroups: Innehållsrollgrupper
TemplateAdminCSHConfigFile: Hämta eller uppdatera CSH-konfigurationsfilen
TemplateAdminElasticReindex: Återskapa sökindex
TemplateAdminExportComments: Exportera kommentarer
TemplateAdminExportRatings: Exportera klassificeringar
TemplateAdminManageManuals: Hantera handböcker
TemplateAdminManageResourceManuals: Hantera resurspaket
TemplateAdminResourceIdCsv: Hämta Excel-filen med ResourceIds
TemplateAdminSitemap: Hantera webbplatskartan
TemplateAdminSubjectSchemeLocalization: Hantera lokalisering av ämnesscheman
TemplateAdminTitle: Administration
TemplateAdminUploadCategoryXML: Hantera XML-filen för kategorin
TemplateAdminUploadCategoryXml: Överför en ny XML-fil för kategorin
TemplateAdminUploadNewLangFile: Överför en ny kodfil för standardspråk
TemplateAdminUploadSubjectScheme: Hantera ämnesschema
TemplateAdminUserGroups: Användargrupper
TemplateAdminUserManagement: Användarhantering
TemplateAdminUserRoles: Användarroller
TemplateBundlePageCollapse: Minimera
TemplateBundlePageCollapseTooltip: Minimera alla rubriker
TemplateBundlePageComments: Kommentarer
TemplateBundlePageContents: Innehåll
TemplateBundlePageExpand: Expandera
TemplateBundlePageExpandTooltip: Expandera innehållsförteckningen
TemplateBundlePageFeedback: Feedback
TemplateBundlePageFeedbackThankYou: Tack! Dina kommentarer har skickats. 
TemplateBundlePageFeedbackTooltip: Skicka feedback
TemplateBundlePageFilterTitle: Välj ett eller flera alternativ
TemplateBundlePageNext: Nästa
TemplateBundlePageNextTopicTooltip: Gå till nästa avsnitt
TemplateBundlePageNo: Nej
TemplateBundlePagePrevious: Föregående 
TemplateBundlePagePrevTopicTooltip: Gå till föregående avsnitt
TemplateBundlePagePrint: Skriv ut
TemplateBundlePagePrintTooltip: Skriv ut avsnitt
TemplateBundlePagePrivacy: Av sekretesskäl ber vi dig att inte inkludera någon kontaktinformation i din feedback. Läs igenom
TemplateBundlePagePrivacyLast: vår sekretesspolicy.
TemplateBundlePageProvideFeedbackCharsLeft: 500 tecken kvar
TemplateBundlePageProvideFeedbackTooltip: Ge feedback
TemplateBundlePageSaveAsPDF: Spara som PDF
TemplateBundlePageSavePDFTooltip: Spara som PDF
TemplateBundlePageSaveSelectedTopic: Spara valt avsnitt
TemplateBundlePageSaveSelectedTopicAndSubtopics: Spara valt avsnitt och delavsnitt
TemplateBundlePageSeeAlso: Se även
TemplateBundlePageSend: Skicka
TemplateBundlePageSendLink: Skicka
TemplateBundlePageSendLinkTooltip: Skicka länk till avsnitt
TemplateBundlePageSubmit: Skicka
TemplateBundlePageWasThisInformationHelpful: Hjälpte den här informationen dig?
TemplateBundlePageYEs: Ja
TemplateBundlesDeleteLanguage: Ta bort språk
TemplateBundlesDeleteManual: Ta bort handbok
TemplateBundlesDownload: Hämta paket
TemplateBundlesDownloadClassification: Hämta klassificerings-XML
TemplateBundlesHiddenBundle: Dold handbok
TemplateBundlesSearchManuals: Sök i handböcker
TemplateBundlesUploadClassification: Överför klassificerings-XML
TemplateClassificationForManual: För handbok
TemplateClassificationUploadClassificationMap: Överför XML för klassificeringskarta
TemplateClassificationWarnReindex: Obs! Om du överför en klassificeringskarta kommer hela webbplatsen att omindexeras. Det kan ta flera minuter.
TemplateContentRolesCRGroups: Innehållsrollgrupper
TemplateContentRolesDefineNewCR: Definiera en ny innehållsroll
TemplateDefaultLayoutAdministration: Administration
TemplateDefaultLayoutArticles: Artiklar
TemplateDefaultLayoutBrowseDocumentation: Bläddra
TemplateDefaultLayoutDocumentation: Dokumentationsbibliotek
TemplateDefaultLayoutHome: Hem
TemplateDefaultLayoutLanguages: United States – English
TemplateDefaultLayoutLinksCareers: Karriär
TemplateDefaultLayoutLinksContactUs: Kontakta oss
TemplateDefaultLayoutLinksIntelCorp: © Intel Corporation
TemplateDefaultLayoutLinksLegalContractsandTerms: Juridiska avtal och villkor
TemplateDefaultLayoutLinksLegalNotices: Juridiska meddelanden 
TemplateDefaultLayoutLinksPrivacy: Privatliv
TemplateDefaultLayoutLinksSiteMap: Webbplatskarta
TemplateDefaultLayoutLinksWebsiteFeedback: Feedback på webbplatsen
TemplateDefaultLayoutLogout: Logga ut
TemplateDefaultLayoutProfile: Profil
TemplateDefaultLayoutVideos: Videor
TemplateFilterCurrentPublication: Aktuell publikation
TemplateRequestResetPasswordEmail: E-post
TemplateRequestResetPasswordSubmit: Begär e-postmeddelande för lösenordsåterställning
TemplateSearchCurrentPublication name@Text: Aktuell sökning är begränsad till publikationen ”#{name}”
TemplateSearchPageClearTooltip: Rensa filter
TemplateSearchPageFirstPageTooltip: Gå till första sidan
TemplateSearchPageLastPageTooltip: Gå till sista sidan
TemplateSearchPageNextPageTooltip: Gå till nästa sida
TemplateSearchPagePrevPageTooltip: Gå till föregående sida
TemplateSearchPublicationTitle: Publikation
TemplateSearchSortbyCreatedAsc: Skapad den – Fallande
TemplateSearchSortbyCreatedDec: Skapad den – Stigande
TemplateSearchSortbyScore: Gradering
TemplateSearchSortbyUpdatedAsc: Tillagd den – Fallande
TemplateSearchSortbyUpdatedDec: Tillagd den – Stigande
TemplateSearchSortbyViews: Antal visningar
TemplatesSearchPageClear: Rensa
TemplatesSearchPageCurrentResultsFirst: Resultat
TemplatesSearchPageCurrentResults: av
TemplatesSearchPageRefilneResults: Begränsa resultaten
TemplatesSearchPageResultUpdated: Uppdaterad
TemplateUploadSitemapDisable: Inaktivera webbplatskarta
TemplateUploadSitemapDisabled: Webbplatskartan har inaktiverats
TemplateUploadSitemapDisabledWord: Inaktiverad
TemplateUploadSitemapDownloadSitemap: Hämta sitemap.xml
TemplateUploadSitemapEnable: Aktivera webbplatskarta
TemplateUploadSitemapEnabled: Webbplatskartan har aktiverats
TemplateUploadSitemapEnabledWord: Aktiverad
TemplateUploadSitemapLegend: Överför sitemap.xml
TemplateUploadSitemapStatus sts@Text: Webbplatskartan är #{sts}
TextPass txt@Text: #{txt}
Upload: Överför
UploadLink: Överför publikation
YesodAuthStormPathSSOErrorOccured: Ett fel inträffade
YesodAuthStormPathSSOLoginParamError: Ett fel uppstod med SSO-inloggningsparametrarna
YesodAuthStormPathSSOLoginTryAgain: Försök logga in igen med