AdvancedSearch: Gelişmiş Arama 
AdvancedSearchTooltip: İçerik filtrelerini seç
BreadcrumbsProductDocumentationHome: Ürün Belgeleri Giriş Sayfası
BreadcrumbsSearch: Ara
Cancel: İptal
Close: Kapat
DeleteText: Sil
ErrorOccured: Bir hata oluştu
FilterUsers: Kullanıcıları filtrele:
FoundationLoginOnly: Oturum aç
FoundationLoginRegister: Oturum aç / Kaydol
HandlerAdminOnlyAdmin: Erişim engellendi
HandlerBundlePageAltCSHResult: Alternatif CSH Konusu Bulundu
HandlerCategoriesCategoryXMLFileUploaded: Kategori XML Dosyası Yüklendi
HandlerClassificationUpdated: Sınıflandırma haritası güncellendi
HandlerClassificationXMLFile: Sınıflandırma Haritası Güncellendi
HandlerCommentsComments: yorumlar
HandlerCommentsOneComment: 1 yorum
HandlerCommentsPostedCommentOn: adlı kişi şu tarihte bir yorum ekledi:
HandlerContentRolesAreYouSureDelete: Bu İçerik Rolünü silmek istediğinizden emin misiniz?
HandlerContentRolesCRDeleted: İçerik Rolü silindi
HandlerContentRolesErrorDeleting: Bir sorun oluştu. İçerik rolü silinemedi.
HandlerCshAlternateCSHTopicFound: Alternatif CSH Konusu bulundu
HandlerCshCSHRulesUpdated: CSH Kuralları Güncellendi
HandlerCshInvalidAliases: CSH URL’sinde Geçersiz Diğer Ad Anahtarları Bulundu
HandlerCshInvalidCSHRulesFile: Geçersiz CSH Kuralları dosyası
HandlerCshNewCshFile: Yeni CSH Yapılandırma Dosyası Yükle
HandlerCshReservedAliasesUsed: CSH Yapılandırma Dosyasında Ayrılan Diğer Adlar Kullanılmış
HandlerCustomError400H2: 400
HandlerCustomError400H3: Hatalı İstek
HandlerCustomError401H2: 401
HandlerCustomError401H3: Yetkilendirilmemiş
HandlerCustomError403H2: 403
HandlerCustomError403H3: Yasaklandı
HandlerCustomError404H2: 404
HandlerCustomError404H3: Bulunamadı
HandlerCustomError405H2: 405
HandlerCustomError405H3: Yönteme İzin Verilmiyor
HandlerCustomError500H2: 500
HandlerCustomError500H3: Dahili Sunucu Hatası
HandlerFontoDocumentSaved: Belge kaydedildi
HandlerFontoErrorGeneratingUUID: UUID oluşturma hatası
HandlerFontoErrorParsingID: Kimlik ayrıştırma hatası
HandlerFontoErrorParsingXML: XML ayrıştırma hatası
HandlerFontoErrorParsingXMLToDocument: XML’i Belgeye Ayrıştırma Hatası
HandlerFontoNoFileFound: Dosya bulunamadı
HandlerFontoNoIDFound: Kimlik bulunamadı
HandlerFontoUntitledFromCursor: Adsız - İmleçten
HandlerGroupsErrorReadingGroupID: Grup kimliği okuma hatası
HandlerGroupsGroupUpdated: Grup Güncellendi
HandlerGroupsMustUseUniqueGroupName: Benzersiz grup adı kullanılmalıdır
HandlerGroupsNoGroupNameFound: Grup adı bulunamadı
HandlerGroupsUnableAssignRole: Rol atanamıyor
HandlerHowtoContent: İçerik
HandlerHowtoDeleted: Makale silindi
HandlerHowtoInsufficientPermissions: Bu Makaleyi düzenlemek için izinler yetersiz
HandlerHowtoSaved: Kaydedildi
HandlerHowtoTitle: Başlık
HandlerHtmlEmptyMyDocs: Boş MyDocs
HandlerLangDefaultLanguageCodeFileUpdated: Varsayılan Dil Kodu Dosyası Güncellendi
HandlerLangNewLangFile: Yeni Varsayılan Dil Kodu Dosyası Yükle
HandlerMyPubSourcePublication: Kaynak Yayını
HandlerProfileDisplayName: Görünen ad
HandlerProfileScreenName: Ekran adı
HandlerProfileUpdated: Profil güncellendi
HandlerProfileUsernameInUse: Kullanıcı adı var
HandlerRatingsInvalidRating: Geçersiz değerlendirme
HandlerRatingsRatingRecorded: Değerlendirmeniz kaydedildi
HandlerRatingsRatingUpdated: Değerlendirmeniz güncellendi
HandlerRolesErrorReadingRoleID: Rol kimliği okuma hatası
HandlerRolesMustUseUniqueRoleName: Benzersiz bir rol adı kullanın
HandlerRolesNoRoleNameFound: Rol adı bulunamadı
HandlerRolesNotEnoughAdminUsersRemaining: Kullanıcılar atanamıyor
HandlerRolesSelectedPermissionsLessThenDefault: İzinler atanamıyor: Seçili izinler, varsayılan izin setinden daha az
HandlerSearchAllResults: Tüm sonuçlar
HandlerSearchNoResultsMsgTryFollowing: Sonuç bulunamadı. aşağıdakileri deneyin:
HandlerSearchNoResultsMsgSpelledCorrectly: Bütün kelimelerin doğru hecelendiğinden emin ol.
HandlerSearchNoResultsMsgTryDifferent: Farklı anahtar kelimeler deneyin.
HandlerSearchNoResultsMsgMoreGeneral: Daha genel anahtar kelimeler deneyin.
HandlerSearchNoResultsMsgNoFindProdVer: ürün veya sürüm bulamıyor musunuz? Intel Güvenlik ServicePortal gidin.
HandlerSearchNoResults: Sonuç yok
HandlerSearchOneResult: Bir sonuç
HandlerSitemapFile: Site haritası dosyası
HandlerSitemapFileUploaded: Site Haritası başarıyla güncellendi.
HandlerSubjectSchemeInvalidSubjectSchemeLocalizationFile: Geçersiz Konu Düzeni Yerelleştirme Dosyası
HandlerSubjectSchemeLangDeleted lang@Text: #{lang} Yerelleştirme Dosyası Silindi
HandlerSubjectSchemeLangsAvailable: Mevcut Diller
HandlerSubjectSchemeLangsDeleteConfirm: Yerelleştirme dosyasını silmek istediğinizden emin misiniz? 
HandlerSubjectSchemeLangsDeleteError: Yerelleştirme dosyası silinirken bir hata oluştu.
HandlerSubjectSchemeLangsNewFile: Yeni SubjectScheme Yerelleştirme Dosyası Yükle
HandlerSubjectSchemeLangUpdated lang@Text: #{lang} Yerelleştirme Dosyası Güncellendi
HandlerSubjectSchemeLangUploaded lang@Text: #{lang} Yerelleştirme Dosyası Yüklendi 
HandlerSubjectSchemeProblemOccurredWhileUploadingSubjectScheme: Konu Düzeni yüklenirken bir sorun oluştu.
HandlerSubjectSchemeSubjectSchemeUploadedSuccessfully: Konu düzeni başarıyla yüklendi
HandlerSubjectSchemeUnknownLanguageCode: Bilinmeyen Dil Kodu
HandlerSubjectSchemeUpdated: Konu düzeni güncellendi
HandlerSubjectSchemeXMLFile: Konu düzeni XML dosyası
HandlerUploadBundleBundle: set
HandlerUploadBundleDeleteError x@Text: #{x} silinirken hata oluştu
HandlerUploadBundleDeleteSuccess x@Text: #{x} başarıyla silindi
HandlerUploadBundleError: Hata
HandlerUploadBundleErrorPleaseUpdateSuiteBundleVersion: Hata - Lütfen setinizin sürümünü güncelleyin
HandlerUploadBundleNoContentToDelete x@Text: #{x} içinde silinecek içerik yok 
HandlerUploadBundleOneBundleError: Yüklenen set doldurulurken hata oluştu
HandlerUploadBundlePublicationUploadedSuccessfully: Yayın başarıyla yüklendi
HandlerUploadBundleSheaf: sheaf
HandlerUsersAddedSuccess: Kullanıcı başarıyla eklendi
HandlerUsersBadEmail: Bu e-posta adresi kayıtlı değil
HandlerUsersCRCreated: İçerik Rol Grubu oluşturuldu
HandlerUsersCRGroupNameInUse: İçerik Rolü adı zaten kullanılıyor
HandlerUsersCRSetGroupName: Lütfen bu İçerik Rol Grubu için bir ad belirleyin
HandlerUsersCRUpdated: İçerik Rol Grubu güncellendi
HandlerUsersDefineCR: Yeni İçerik Rol Grubu Tanımla
HandlerUsersDeleteSuccess: Kullanıcı başarıyla silindi
HandlerUsersEmailError: Parola sıfırlama e-postası gönderilirken bir hata oluştu
HandlerUsersInvalidToken: Geçersiz Belirteç
HandlerUsersNoResetToken: Sıfırlama belirteci yok
HandlerUsersNoRoleIdFound: Rol kimliği bulunamadı
HandlerUsersPasswordEmailSent: Parola sıfırlama e-postası gönderildi
HandlerUsersRegisterSuccess: Kullanıcı başarıyla kaydedildi
HandlerUsersResetPasswordError: Parola sıfırlanırken bir hata oluştu
HandlerUsersRolesUpdated: Kullanıcı Rolleri Güncellendi
HandlerUsersUnableToAssignUserPermissionRole: Kullanıcıya izin rolü atanamıyor
HandlerUsersUnknownError: Bilinmeyen hata
HideTOC: İçindekileri gizle
ImportAddHelperProblemRunningAddHelper: addHelper çalıştırılırken sorun oluştu
ImportBundlesTooManyTopics num@Int: En fazla #{show num} konu yayımlanabilir. Lütfen daha az konu seçip tekrar deneyin.
ImportElasticAnalyzerError: - Not: Özel çözümleyici hatası, ayrıntılar için günlük dosyasına bakın. Varsayılan çözümleyici kullanılıyor. 
ImportElasticErrorRebuilding: Dizin yeniden oluşturma hatası - daha fazla ayrıntı için günlük dosyasına bakın.
ImportElasticErrorUpdating: Dizin güncelleme hatası - daha fazla ayrıntı için günlük dosyasına bakın.
ImportElasticIndexRebuilt x@Text: Dizin başarıyla yeniden oluşturuldu #{x}
ImportElasticIndexUpdated x@Text: Dizin başarıyla güncellendi #{x}
ImportElasticNoPagesFound: Veritabanında Sayfa bulunamadı - dizin sıfırlaması.
ImportElasticNoPagesInBundle: Yüklemede Sayfa bulunamadı
ImportInvalidPassword: Geçersiz parola
ImportRatingsOneRating: 1 Değerlendirme
ImportRatingsRatings: Değerlendirmeler
ImportRolesPermissionDenied: İzin reddedildi
ImportSearchNoCategoriesUploaded: Kategori XML Dosyası Yüklenmedi
ImportSearchUnknownTopicLink: *** bilinmeyen konu bağlantısı ***
ImportUsersCaptchaError: Geçersiz reCAPTCHA 
ImportUsersCaptchaParseError: reCAPTCHA Hatası
ImportUsersEmailFieldError: E-posta alanı bulunamadı.
ImportUsersFldEmail: E-posta
ImportUsersFldFirstName: Ad
ImportUsersFldLastName: Soyadı
ImportUsersFldPassword: Parola
ImportUsersFldReenterPass: Parolayı tekrar gir
ImportUsersInvalidPass: Geçersiz parola: Seçilen parola, en az 8 karakter uzunluğunda olmalı ve en az 1 büyük harf, 1 küçük harf, 1 özel karakter ve 1 rakam içermelidir.
LoggedInAs email@Text: #{email} olarak oturum açıldı.
Manuals: Kullanım Kılavuzları
PDFPage: Sayfa
ProductDocumentationSplashTitle: Ürün Belgeleri 
PublishHowto: Yayımla
ResultsPerPage: Sayfa başına sonuçlar
ResultsPerPageShowFirst: Sayfa başına 
ResultsPerPageShow: sonuç göster
Search: Ürün Belgelerinde ara
SearchContent: Bu içerikte ara
SearchHome: Ürün Belgelerinde Ara
ShowTOC: İçindekileri göster
SSOLoginParamError: SSO oturum açma parametrelerinde hata oluştu
SSOLoginTryAgain: Şununla yeniden oturum açmayı deneyin:
SwitchLang: Dili değiştir
TemplaesBundlesTitle: Belge Kitaplığı
TemplateAddHelperCancel: İptal
TemplateAddHelperSave: Kaydet
TemplateAddHelperSaveAndClose: Kaydet ve Kapat
TemplateAddUserAddUser: Kullanıcı Ekle
TemplateAddUserCancel: İptal
TemplateAddUserPasswordMessage: Parola, 8 karakter uzunluğunda olmalı ve en az 1 büyük harf, 1 küçük harf, 1 özel karakter ve 1 rakam içermelidir.
TemplateAdminArticleManagement: Makale Yönetimi
TemplateAdminContentRoleGroups: İçerik Rol Grupları
TemplateAdminCSHConfigFile: CSH Yapılandırma dosyasını indir veya güncelle
TemplateAdminElasticReindex: Arama Dizinini Yeniden Oluştur
TemplateAdminExportComments: Yorumları Dışa Aktar
TemplateAdminExportRatings: Değerlendirmeleri Dışa Aktar
TemplateAdminManageManuals: Kullanım Kılavuzlarını Yönet
TemplateAdminManageResourceManuals: Kaynak Paketlerini yönet
TemplateAdminResourceIdCsv: ResourceIds Excel dosyasını indir
TemplateAdminSitemap: Site Haritasını yönet
TemplateAdminSubjectSchemeLocalization: Konu Düzeni Yerelleştirmesini Yönet
TemplateAdminTitle: Yönetim
TemplateAdminUploadCategoryXML: Kategori XML dosyasını yönet
TemplateAdminUploadCategoryXml: Yeni bir Kategori XML dosyası yükle
TemplateAdminUploadNewLangFile: Yeni bir Varsayılan Dil Kodu dosyası yükle
TemplateAdminUploadSubjectScheme: Konu Düzenini Yönet
TemplateAdminUserGroups: Kullanıcı Grupları
TemplateAdminUserManagement: Kullanıcı Yönetimi
TemplateAdminUserRoles: Kullanıcı Rolleri
TemplateBundlePageCollapse: Daralt
TemplateBundlePageCollapseTooltip: Tüm Başlıkları Daralt
TemplateBundlePageComments: Yorumlar
TemplateBundlePageContents: İçindekiler
TemplateBundlePageExpand: Genişlet
TemplateBundlePageExpandTooltip: İçindekileri genişlet
TemplateBundlePageFeedback: Geri Bildirim
TemplateBundlePageFeedbackThankYou: Teşekkür ederiz! Yorumlarınız gönderildi. 
TemplateBundlePageFeedbackTooltip: Geri Bildirim Gönder
TemplateBundlePageFilterTitle: Bir veya daha fazla seçenek belirle
TemplateBundlePageNext: Sonraki
TemplateBundlePageNextTopicTooltip: Sonraki Konuya Git
TemplateBundlePageNo: Hayır
TemplateBundlePagePrevious: Geri 
TemplateBundlePagePrevTopicTooltip: Önceki Konuya Git
TemplateBundlePagePrint: Yazdır
TemplateBundlePagePrintTooltip: Konuyu Yazdır
TemplateBundlePagePrivacy: Gizliliğinizi korumak için geri bildiriminize iletişim bilgileri eklemeyin. Gizlilik
TemplateBundlePagePrivacyLast: ilkemizi inceleyin.
TemplateBundlePageProvideFeedbackCharsLeft: 500 karakter kaldı
TemplateBundlePageProvideFeedbackTooltip: Geri Bildirim Ver
TemplateBundlePageSaveAsPDF: PDF Olarak Kaydet
TemplateBundlePageSavePDFTooltip: PDF Olarak Kaydet
TemplateBundlePageSaveSelectedTopic: Seçilen konuyu kaydet
TemplateBundlePageSaveSelectedTopicAndSubtopics: Seçilen konuyu ve alt konuları kaydet
TemplateBundlePageSeeAlso: Ayrıca bkz.
TemplateBundlePageSend: Gönder
TemplateBundlePageSendLink: Gönder
TemplateBundlePageSendLinkTooltip: Konuya Bağlantı Gönder
TemplateBundlePageSubmit: Gönder
TemplateBundlePageWasThisInformationHelpful: Bu bilgi yardımcı oldu mu?
TemplateBundlePageYEs: Evet
TemplateBundlesDeleteLanguage: Dil seçeneğini sil
TemplateBundlesDeleteManual: Kullanım kılavuzunu sil
TemplateBundlesDownload: Seti indir
TemplateBundlesDownloadClassification: Sınıflandırma XML’ini indir
TemplateBundlesHiddenBundle: Gizli kullanım kılavuzu
TemplateBundlesSearchManuals: Kullanım Kılavuzlarında Ara
TemplateBundlesUploadClassification: Sınıflandırma XML’ini yükle
TemplateClassificationForManual: Kullanım kılavuzu için
TemplateClassificationUploadClassificationMap: Sınıflandırma Haritası XML’ini Yükle
TemplateClassificationWarnReindex: NOT: Sınıflandırma Haritası yüklendiğinde tüm site dizini yeniden oluşturulur. Bu işlem birkaç dakika sürebilir.
TemplateContentRolesCRGroups: İçerik Rol Grupları
TemplateContentRolesDefineNewCR: Yeni İçerik Rolü Tanımla
TemplateDefaultLayoutAdministration: Yönetim
TemplateDefaultLayoutArticles: Makaleler
TemplateDefaultLayoutBrowseDocumentation: Gözat
TemplateDefaultLayoutDocumentation: Belge Kitaplığı
TemplateDefaultLayoutHome: Giriş Sayfası
TemplateDefaultLayoutLanguages: United States - English
TemplateDefaultLayoutLinksCareers: Kariyer Fırsatları
TemplateDefaultLayoutLinksContactUs: Bize Ulaşın
TemplateDefaultLayoutLinksIntelCorp: © Intel Corporation
TemplateDefaultLayoutLinksLegalContractsandTerms: Yasal Sözleşmeler ve Koşullar
TemplateDefaultLayoutLinksLegalNotices: Yasal Bildirimler 
TemplateDefaultLayoutLinksPrivacy: Gizlilik
TemplateDefaultLayoutLinksSiteMap: Site Haritası
TemplateDefaultLayoutLinksWebsiteFeedback: Web Sitesi Geri Bildirimi
TemplateDefaultLayoutLogout: Oturumu kapat
TemplateDefaultLayoutProfile: Profil
TemplateDefaultLayoutVideos: Videolar
TemplateFilterCurrentPublication: Geçerli Yayın
TemplateRequestResetPasswordEmail: E-posta
TemplateRequestResetPasswordSubmit: Parola Sıfırlama E-postası İste
TemplateSearchCurrentPublication name@Text: Geçerli arama '#{name}' adlı yayınla sınırlıdır
TemplateSearchPageClearTooltip: Filtreleri temizle
TemplateSearchPageFirstPageTooltip: İlk Sayfaya Git
TemplateSearchPageLastPageTooltip: Son Sayfaya Git
TemplateSearchPageNextPageTooltip: Sonraki Sayfaya Git
TemplateSearchPagePrevPageTooltip: Önceki sayfaya git
TemplateSearchPublicationTitle: Yayın
TemplateSearchSortbyCreatedAsc: Oluşturulma Tarihi – Eskiden Yeniye
TemplateSearchSortbyCreatedDec: Oluşturulma Tarihi - Yeniden Eskiye
TemplateSearchSortbyScore: Puan
TemplateSearchSortbyUpdatedAsc: Eklenme Tarihi – Eskiden Yeniye
TemplateSearchSortbyUpdatedDec: Eklenme Tarihi – Yeniden Eskiye
TemplateSearchSortbyViews: Görüntülenme Sayısı
TemplatesSearchPageClear: Temizle
TemplatesSearchPageCurrentResultsFirst: sonuçtan
TemplatesSearchPageCurrentResults: tanesi
TemplatesSearchPageRefilneResults: Sonuçları Daralt
TemplatesSearchPageResultUpdated: Güncelleme tarihi:
TemplateUploadSitemapDisable: Site haritasını devre dışı bırak
TemplateUploadSitemapDisabled: Site haritası devre dışı bırakıldı
TemplateUploadSitemapDisabledWord: Devre dışı
TemplateUploadSitemapDownloadSitemap: Sitemap.xml dosyasını indir
TemplateUploadSitemapEnable: Site haritasını etkinleştir
TemplateUploadSitemapEnabled: Site haritası etkinleştirildi
TemplateUploadSitemapEnabledWord: Etkin
TemplateUploadSitemapLegend: Sitemap.xml dosyasını yükle
TemplateUploadSitemapStatus sts@Text: Site haritası #{sts}
TextPass txt@Text: #{txt}
Upload: Yükle
UploadLink: Yayını yükle
YesodAuthStormPathSSOErrorOccured: Bir hata oluştu
YesodAuthStormPathSSOLoginParamError: SSO oturum açma parametrelerinde hata oluştu
YesodAuthStormPathSSOLoginTryAgain: Şununla yeniden oturum açmayı deneyin: